samples,r.squared,distinct,points,removed,final,remaining
RC2_0003_ICR-3_p08,0.934588350674488,676,689,61,628,0.911465892597968
RC2_0004_ICR-1_p08,0.936575190823776,697,718,76,642,0.894150417827298
RC2_0004_ICR-2_p08,0.928495302805113,677,698,64,634,0.908309455587393
RC2_0004_ICR-3_p08,0.929165931706104,685,711,80,631,0.887482419127989
RC2_0005_ICR-1_p08,0.92806449659228,688,719,87,632,0.878998609179416
RC2_0005_ICR-2_p08,0.934171172033051,689,720,77,643,0.893055555555556
RC2_0005_ICR-3_p08,0.918167774437786,646,665,77,588,0.884210526315789
RC2_0006_ICR-1_p08,0.926606662617981,699,733,92,641,0.874488403819918
RC2_0006_ICR-2_p08,0.927246367976814,683,716,85,631,0.881284916201117
RC2_0006_ICR-3_p08,0.923240616072748,667,699,84,615,0.879828326180258
RC2_0007_ICR-1_p08,0.92365822239997,630,646,76,570,0.882352941176471
RC2_0007_ICR-2_p08,0.923078516942409,626,639,59,580,0.907668231611894
RC2_0007_ICR-3_p08,0.928873085941594,612,629,68,561,0.891891891891892
RC2_0008_ICR-1_p08,0.922912100131711,611,634,69,565,0.891167192429022
RC2_0008_ICR-2_p08,0.930188090325453,651,669,58,611,0.913303437967115
RC2_0008_ICR-3_p08,0.933777867044407,680,706,70,636,0.900849858356941
RC2_0009_ICR-1_p08,0.933719444402094,699,723,68,655,0.905947441217151
RC2_0009_ICR-2_p08,0.932649315122843,676,701,65,636,0.907275320970043
RC2_0009_ICR-3_p08,0.933678230160517,699,733,77,656,0.894952251023192
RC2_0010_ICR-1_p08,0.933856401635488,676,700,67,633,0.904285714285714
RC2_0010_ICR-2_p08,0.924217567368291,651,670,65,605,0.902985074626866
RC2_0010_ICR-3_p08,0.924664897412845,649,664,73,591,0.890060240963855
RC2_0011_ICR-1_p08,0.9213902526266,632,661,76,585,0.885022692889561
RC2_0011_ICR-2_p08,0.909586828809277,606,632,81,551,0.871835443037975
RC2_0011_ICR-3_p08,0.919756572539252,635,655,74,581,0.887022900763359
RC2_0012_ICR-1_p08,0.925590234020393,644,669,68,601,0.898355754857997
RC2_0012_ICR-2_p08,0.91672439216581,600,623,80,543,0.871589085072231
RC2_0012_ICR-3_p08,0.923473513598903,629,642,66,576,0.897196261682243
RC2_0013_ICR-1_p08,0.926078269211309,637,649,61,588,0.906009244992296
RC2_0013_ICR-2_p08,0.921174314073007,621,635,73,562,0.88503937007874
RC2_0013_ICR-3_p08,0.923906694380235,599,624,87,537,0.860576923076923
RC2_0014_ICR-1_p08,0.921451656223419,630,639,71,568,0.888888888888889
RC2_0014_ICR-2_p08,0.915337194417753,605,618,65,553,0.894822006472492
RC2_0014_ICR-3_p08,0.925036069569927,639,661,80,581,0.878971255673222
RC2_0015_ICR-1_p08,0.935416487034331,713,743,81,662,0.890982503364737
RC2_0015_ICR-2_p08,0.925223424412063,649,680,77,603,0.886764705882353
RC2_0015_ICR-3_p08,0.920552293425257,598,619,78,541,0.873990306946688
RC2_0016_ICR-1_p08,0.934830193118776,690,712,69,643,0.903089887640449
RC2_0016_ICR-2_p08,0.906073938136563,576,595,87,508,0.853781512605042
RC2_0016_ICR-3_p08,0.930268532276531,682,715,89,626,0.875524475524476
RC2_0017_ICR-1_p08,0.93050911400336,703,731,78,653,0.893296853625171
RC2_0017_ICR-2_p08,0.898876790512443,574,594,65,529,0.890572390572391
RC2_0017_ICR-3_p08,0.930434062048636,662,693,90,603,0.87012987012987
RC2_0018_ICR-1_p08,0.923353701811757,616,636,65,571,0.897798742138365
RC2_0018_ICR-2_p08,0.912153218283351,620,637,67,570,0.894819466248038
RC2_0018_ICR-3_p08,0.921415428105972,618,648,70,578,0.891975308641975
RC2_0019_ICR-2_p08,0.912529720758677,629,640,71,569,0.8890625
RC2_0019_ICR-3_p08,0.92118768869731,606,624,68,556,0.891025641025641
RC2_0020_ICR-1_p08,0.922037740113913,622,636,66,570,0.89622641509434
RC2_0020_ICR-2_p08,0.933916553635775,707,732,71,661,0.903005464480874
RC2_0020_ICR-3_p08,0.930134164693581,638,658,56,602,0.914893617021277
RC2_0021_ICR-1_p08,0.935301386374233,713,748,87,661,0.883689839572192
RC2_0021_ICR-2_p08,0.92749076590153,649,672,90,582,0.866071428571429
RC2_0021_ICR-3_p08,0.914151191612593,600,618,73,545,0.881877022653722
RC2_0022_ICR-1_p08,0.922440726693204,635,655,61,594,0.906870229007634
RC2_0022_ICR-2_p08,0.929652778079812,695,720,76,644,0.894444444444444
RC2_0022_ICR-3_p08,0.922555348267815,653,686,84,602,0.877551020408163
RC2_0023_ICR-1_p08,0.920475373946054,608,632,70,562,0.889240506329114
RC2_0023_ICR-2_p08,0.919873075592483,635,658,79,579,0.879939209726444
RC2_0023_ICR-3_p08,0.924481148190179,624,650,90,560,0.861538461538462
RC2_0024_ICR-1_p08,0.9061478453473,579,598,85,513,0.857859531772575
RC2_0024_ICR-2_p08,0.930184561435938,626,654,87,567,0.86697247706422
RC2_0024_ICR-3_p08,0.917490979847311,629,652,75,577,0.884969325153374
RC2_0025_ICR-1_p08,0.923948921241452,652,669,79,590,0.881913303437967
RC2_0025_ICR-2_p08,0.917651036284977,609,628,70,558,0.888535031847134
RC2_0025_ICR-3_p08,0.919708765915552,614,634,61,573,0.903785488958991
RC2_0026_ICR-1_p08,0.925601508021117,639,657,65,592,0.901065449010654
RC2_0026_ICR-2_p08,0.925196104535411,655,672,77,595,0.885416666666667
RC2_0026_ICR-3_p08,0.932467565517798,663,680,69,611,0.898529411764706
RC2_0027_ICR-1_p08,0.929766384543108,654,677,70,607,0.896602658788774
RC2_0027_ICR-2_p08,0.921309006887906,627,647,88,559,0.863987635239567
RC2_0027_ICR-3_p08,0.92460701398395,632,660,73,587,0.889393939393939
RC2_0028_ICR-1_p08,0.930189937481405,669,695,81,614,0.883453237410072
RC2_0028_ICR-2_p08,0.928912516009861,675,698,72,626,0.896848137535817
RC2_0028_ICR-3_p08,0.914303150371972,615,628,58,570,0.907643312101911
RC2_0029_ICR-1_p08,0.923428317682429,671,700,87,613,0.875714285714286
RC2_0029_ICR-2_p08,0.920289266809039,634,662,91,571,0.862537764350453
RC2_0029_ICR-3_p08,0.914896164913883,647,678,83,595,0.877581120943953
RC2_0030_ICR-1_p08,0.916096855195768,619,641,55,586,0.914196567862715
RC2_0030_ICR-2_p08,0.918596737109418,659,691,91,600,0.868306801736614
RC2_0030_ICR-3_p08,0.903182249822564,573,588,72,516,0.877551020408163
RC2_0031_ICR-1_p08,0.886780518046492,565,567,67,500,0.881834215167548
RC2_0031_ICR-2_p08,0.906093714261293,632,648,78,570,0.87962962962963
RC2_0031_ICR-3_p08,0.909157881430657,579,590,68,522,0.884745762711864
RC2_0032_ICR-1_p08,0.929806836226789,687,698,74,624,0.893982808022923
RC2_0032_ICR-2_p08,0.923519135938421,661,672,82,590,0.87797619047619
RC2_0032_ICR-3_p08,0.927052334463062,656,667,77,590,0.88455772113943
RC2_0033_ICR-1_p08,0.923790159917936,632,653,97,556,0.85145482388974
RC2_0033_ICR-2_p08,0.929052208988934,666,686,84,602,0.877551020408163
RC2_0033_ICR-3_p08,0.925535954740406,638,659,88,571,0.866464339908953
RC2_0034_ICR-1_p08,0.907703283935554,622,630,63,567,0.9
RC2_0034_ICR-2_p08,0.920725014711731,636,658,83,575,0.873860182370821
RC2_0034_ICR-3_p08,0.926601886515154,679,698,79,619,0.886819484240688
RC2_0035_ICR-1_p08,0.925161591942831,667,695,83,612,0.880575539568345
RC2_0035_ICR-2_p08,0.922969205623265,670,688,79,609,0.885174418604651
RC2_0035_ICR-3_p08,0.92266196615019,675,695,77,618,0.889208633093525
RC2_0036_ICR-1_p08,0.92095296548919,662,687,85,602,0.87627365356623
RC2_0036_ICR-2_p08,0.924202493302504,646,671,98,573,0.853949329359165
RC2_0036_ICR-3_p08,0.903714208742409,600,607,71,536,0.883031301482702
RC2_0037_ICR-1_p08,0.925476419894094,713,734,89,645,0.87874659400545
RC2_0037_ICR-2_p08,0.933852727894873,733,753,86,667,0.885790172642762
RC2_0037_ICR-3_p08,0.930814106735582,728,747,83,664,0.888888888888889
RC2_0038_ICR-1_p08,0.927428229733016,694,715,89,626,0.875524475524476
RC2_0038_ICR-2_p08,0.924401272933689,654,662,70,592,0.894259818731118
RC2_0038_ICR-3_p08,0.93494024683514,735,747,75,672,0.899598393574297
RC2_0039_ICR-1_p08,0.923004782116583,689,709,91,618,0.871650211565585
RC2_0039_ICR-2_p08,0.918585839521761,666,672,74,598,0.889880952380952
RC2_0039_ICR-3_p08,0.928415396680379,705,735,102,633,0.861224489795918
RC2_0040_ICR-1_p08,0.918294353494111,646,664,73,591,0.890060240963855
RC2_0040_ICR-2_p08,0.902776666852279,640,650,73,577,0.887692307692308
RC2_0040_ICR-3_p08,0.928951414612094,703,736,90,646,0.877717391304348
RC2_0041_ICR-1_p08,0.920652850476954,663,690,85,605,0.876811594202899
RC2_0041_ICR-2_p08,0.925271478202189,661,690,98,592,0.857971014492754
RC2_0041_ICR-3_p08,0.891161841660195,581,586,68,518,0.883959044368601
RC2_0042_ICR-1_p08,0.902286348785627,592,602,72,530,0.880398671096346
RC2_0042_ICR-2_p08,0.919836963988626,639,670,94,576,0.859701492537313
RC2_0042_ICR-3_p08,0.898122898237389,590,605,87,518,0.856198347107438
RC2_0043_ICR-1_p08,0.879410751406534,614,618,77,541,0.875404530744337
RC2_0043_ICR-2_p08,0.837511652318331,602,607,77,530,0.873146622734761
RC2_0043_ICR-3_p08,0.795598396815209,496,499,49,450,0.901803607214429
RC2_0044_ICR-1_p08,0.900880484737385,650,656,77,579,0.882621951219512
RC2_0044_ICR-2_p08,0.802280112686965,552,555,59,496,0.893693693693694
RC2_0044_ICR-3_p08,0.88677309922661,694,695,89,606,0.871942446043166
RC2_0045_ICR-1_p08,0.894822263675984,697,708,94,614,0.867231638418079
RC2_0045_ICR-2_p08,0.91774870154421,718,737,89,648,0.879240162822252
RC2_0045_ICR-3_p08,0.901711020663306,678,690,83,607,0.879710144927536
RC2_0046_ICR-1_p08,0.891525936026148,662,673,95,578,0.858841010401189
RC2_0046_ICR-2_p08,0.863771526712744,667,674,96,578,0.857566765578635
RC2_0046_ICR-3_p08,0.891230389251289,704,713,106,607,0.85133239831697
RC2_0048_ICR-1_p08,0.877399167415931,650,656,109,547,0.833841463414634
RC2_0048_ICR-2_p08,0.863715703473197,615,626,73,553,0.883386581469649
RC2_0048_ICR-3_p08,0.910824140478351,669,691,79,612,0.885672937771346
RC2_0049_ICR-1_p08,0.844253044462181,638,644,85,559,0.868012422360248
RC2_0049_ICR-2_p08,0.864484809665775,654,672,99,573,0.852678571428571
RC2_0049_ICR-3_p08,0.896649898065113,719,726,122,604,0.831955922865014
RC2_0050_ICR-1_p08,0.867542299077408,652,664,88,576,0.867469879518072
RC2_0050_ICR-2_p08,0.876947915384055,669,680,99,581,0.854411764705882
RC2_0050_ICR-3_p08,0.897724992537949,694,703,99,604,0.859174964438122
RC2_0051_ICR-1_p08,0.913914641689031,699,704,66,638,0.90625
RC2_0051_ICR-2_p08,0.845587627119123,628,629,75,554,0.880763116057234
RC2_0051_ICR-3_p08,0.922457119304797,727,736,96,640,0.869565217391304
RC2_0052_ICR-1_p08,0.915342511636631,700,714,90,624,0.873949579831933
RC2_0052_ICR-2_p08,0.921717694082256,730,745,99,646,0.867114093959731
RC2_0052_ICR-3_p08,0.848893662232245,610,612,60,552,0.901960784313726
RC2_0053_ICR-1_p08,0.898543327774021,697,715,87,628,0.878321678321678
RC2_0053_ICR-2_p08,0.896328889246684,674,683,90,593,0.868228404099561
RC2_0053_ICR-3_p08,0.854282081240172,615,622,79,543,0.872990353697749
RC2_0054_ICR-1_p08,0.825737520407368,660,664,100,564,0.849397590361446
RC2_0054_ICR-2_p08,0.907765365159799,683,708,101,607,0.857344632768362
RC2_0054_ICR-3_p08,0.887936640859601,691,701,104,597,0.851640513552068
RC2_0055_ICR-1_p08,0.878892032749512,610,621,68,553,0.890499194847021
RC2_0055_ICR-2_p08,0.900533570123684,685,695,102,593,0.853237410071942
RC2_0055_ICR-3_p08,0.906087767272841,737,753,112,641,0.851261620185923
RC2_0056_ICR-1_p08,0.9264159529243,742,755,90,665,0.880794701986755
RC2_0056_ICR-2_p08,0.887571918325622,716,723,93,630,0.871369294605809
RC2_0056_ICR-3_p08,0.917282082982619,667,679,81,598,0.880706921944035
RC2_0057_ICR-1_p08,0.880226615674281,697,708,98,610,0.861581920903955
RC2_0057_ICR-2_p08,0.878031641187688,682,699,97,602,0.861230329041488
RC2_0057_ICR-3_p08,0.909901750686106,742,758,115,643,0.848284960422164
RC2_0058_ICR-1_p08,0.909639955577562,694,717,109,608,0.847977684797768
RC2_0058_ICR-2_p08,0.813191929281592,635,639,110,529,0.827856025039124
RC2_0058_ICR-3_p08,0.856452222510559,677,684,109,575,0.840643274853801
RC2_0059_ICR-1_p08,0.878692281582103,684,701,121,580,0.827389443651926
RC2_0059_ICR-2_p08,0.896611233119493,679,698,112,586,0.839541547277937
RC2_0059_ICR-3_p08,0.818610090380545,601,609,86,523,0.858784893267652
RC2_0060_ICR-1_p08,0.874801719681467,669,682,100,582,0.853372434017595
RC2_0060_ICR-2_p08,0.910905008382591,660,677,92,585,0.86410635155096
RC2_0060_ICR-3_p08,0.902746416240794,694,706,119,587,0.831444759206799
RC2_0061_ICR-1_p08,0.827962797908666,583,589,80,509,0.864176570458404
RC2_0061_ICR-2_p08,0.841540988502328,560,564,72,492,0.872340425531915
RC2_0061_ICR-3_p08,0.810560337501776,571,578,68,510,0.882352941176471
RC2_0062_ICR-1_p08,0.820424174182406,648,650,84,566,0.870769230769231
RC2_0062_ICR-2_p08,0.919623353211681,702,712,105,607,0.85252808988764
RC2_0062_ICR-3_p08,0.905480876116882,693,703,93,610,0.867709815078236
RC2_0063_ICR-1_p08,0.871631924484874,688,696,100,596,0.85632183908046
RC2_0063_ICR-2_p08,0.917303325712149,690,711,92,619,0.870604781997187
RC2_0063_ICR-3_p08,0.912337228282851,669,688,97,591,0.859011627906977
RC2_0064_ICR-1_p08,0.907122535887464,680,694,85,609,0.877521613832853
RC2_0064_ICR-2_p08,0.872860538396852,635,639,71,568,0.888888888888889
RC2_0064_ICR-3_p08,0.883361104507252,687,702,102,600,0.854700854700855
RC2_0065_ICR-1_p08,0.850278619825825,630,642,85,557,0.867601246105919
RC2_0065_ICR-2_p08,0.867379580553619,579,594,95,499,0.84006734006734
RC2_0065_ICR-3_p08,0.888805994378371,611,625,92,533,0.8528
RC2_0066_ICR-1_p08,0.87233984847234,621,632,86,546,0.863924050632911
RC2_0066_ICR-2_p08,0.882390445953446,623,642,92,550,0.856697819314642
RC2_0066_ICR-3_p08,0.85193771028799,615,625,85,540,0.864
RC2_0067_ICR-1_p08,0.87431035500557,600,602,68,534,0.887043189368771
RC2_0067_ICR-2_p08,0.714078928075929,467,468,48,420,0.897435897435897
RC2_0067_ICR-3_p08,0.665329018035459,435,437,40,397,0.908466819221968
RC2_0068_ICR-1_p08,0.897125229336915,657,662,97,565,0.853474320241692
RC2_0068_ICR-2_p08,0.880740563443192,683,688,96,592,0.86046511627907
RC2_0068_ICR-3_p08,0.916392825907828,670,678,86,592,0.873156342182891
RC2_0069_ICR-1_p08,0.919725405573638,695,711,87,624,0.877637130801688
RC2_0069_ICR-2_p08,0.85522682608823,655,660,81,579,0.877272727272727
RC2_0069_ICR-3_p08,0.920512016084014,699,721,79,642,0.890429958391123
RC2_0070_ICR-1_p08,0.895876610081982,689,705,110,595,0.843971631205674
RC2_0070_ICR-2_p08,0.786222854124656,492,493,46,447,0.906693711967546
RC2_0070_ICR-3_p08,0.908400961470428,724,732,104,628,0.85792349726776
RC2_0071_ICR-1_p08,0.882930782553794,644,659,95,564,0.855842185128983
RC2_0071_ICR-2_p08,0.887140341218513,658,669,115,554,0.828101644245142
RC2_0071_ICR-3_p08,0.846591384820221,612,617,98,519,0.841166936790924
RC2_0072_ICR-1_p08,0.88457917680899,608,623,66,557,0.894060995184591
RC2_0072_ICR-2_p08,0.812619232404961,513,516,49,467,0.905038759689923
RC2_0072_ICR-3_p08,0.888108126890671,667,680,113,567,0.833823529411765
RC2_0073_ICR-1_p08,0.840461056360717,622,626,75,551,0.880191693290735
RC2_0073_ICR-2_p08,0.869291195983119,663,670,119,551,0.822388059701493
RC2_0073_ICR-3_p08,0.876527469696831,592,607,77,530,0.873146622734761
RC2_0074_ICR-1_p08,0.861177354803807,629,639,98,541,0.846635367762128
RC2_0074_ICR-2_p08,0.837734395855478,617,624,90,534,0.855769230769231
RC2_0074_ICR-3_p08,0.874920238071692,594,604,72,532,0.880794701986755
RC2_0075_ICR-1_p08,0.856056677326819,662,667,108,559,0.83808095952024
RC2_0075_ICR-2_p08,0.884848443063277,707,716,105,611,0.853351955307263
RC2_0075_ICR-3_p08,0.906204745206828,652,663,79,584,0.880844645550528
RC2_0076_ICR-1_p08,0.913691632143911,695,716,105,611,0.853351955307263
RC2_0076_ICR-2_p08,0.885883678832409,692,702,90,612,0.871794871794872
RC2_0076_ICR-3_p08,0.913601507003058,699,715,90,625,0.874125874125874
RC2_0077_ICR-1_p08,0.919798004751058,702,714,86,628,0.879551820728291
RC2_0077_ICR-2_p08,0.912432794807477,727,740,104,636,0.859459459459459
RC2_0077_ICR-3_p08,0.896342690001138,680,687,99,588,0.85589519650655
RC2_0078_ICR-1_p08,0.78465121200634,545,550,63,487,0.885454545454545
RC2_0078_ICR-2_p08,0.817448216813725,541,545,76,469,0.860550458715596
RC2_0078_ICR-3_p08,0.720435512409371,496,498,42,456,0.91566265060241
RC2_0079_ICR-1_p08,0.842179229030569,519,520,55,465,0.894230769230769
RC2_0079_ICR-2_p08,0.848300394046257,537,542,80,462,0.85239852398524
RC2_0079_ICR-3_p08,0.858883617876194,511,514,51,463,0.900778210116732
RC2_0080_ICR-1_p08,0.908127635423317,689,696,87,609,0.875
RC2_0080_ICR-2_p08,0.849820656084663,573,576,68,508,0.881944444444444
RC2_0080_ICR-3_p08,0.897799939168629,647,654,99,555,0.848623853211009
RC2_0081_ICR-1_p08,0.864977752395136,674,685,86,599,0.874452554744526
RC2_0081_ICR-2_p08,0.840698351851541,597,602,61,541,0.898671096345515
RC2_0081_ICR-3_p08,0.903699127662512,671,687,95,592,0.861717612809316
RC2_0082_ICR-1_p08,0.891369837886033,698,709,99,610,0.860366713681241
RC2_0082_ICR-2_p08,0.896609523222622,686,697,108,589,0.845050215208034
RC2_0082_ICR-3_p08,0.901058597805474,663,681,92,589,0.864904552129222
RC2_0083_ICR-1_p08,0.867352490528216,633,649,88,561,0.864406779661017
RC2_0083_ICR-2_p08,0.86852036344003,591,606,89,517,0.853135313531353
RC2_0083_ICR-3_p08,0.84285879928627,616,623,86,537,0.861958266452649
RC2_0084_ICR-1_p08,0.846984981078837,593,602,75,527,0.875415282392027
RC2_0084_ICR-2_p08,0.89568206828833,639,657,114,543,0.82648401826484
RC2_0084_ICR-3_p08,0.899929268217255,644,655,79,576,0.879389312977099
RC2_0085_ICR-1_p08,0.696403441333733,503,508,71,437,0.860236220472441
RC2_0085_ICR-2_p08,0.698249754915369,460,463,55,408,0.881209503239741
RC2_0085_ICR-3_p08,0.760558238781085,530,534,62,472,0.883895131086142
RC2_0086_ICR-1_p08,0.91734264946006,638,641,70,571,0.890795631825273
RC2_0086_ICR-2_p08,0.907237325212613,667,674,81,593,0.879821958456973
RC2_0086_ICR-3_p08,0.882853732294567,633,637,71,566,0.888540031397174
RC2_0087_ICR-1_p08,0.912430900226787,667,686,105,581,0.846938775510204
RC2_0087_ICR-2_p08,0.874983893775581,667,672,78,594,0.883928571428571
RC2_0087_ICR-3_p08,0.922202392143237,700,718,90,628,0.874651810584958
RC2_0088_ICR-1_p08,0.8468647702576,648,652,86,566,0.868098159509202
RC2_0088_ICR-2_p08,0.898607776154999,678,692,89,603,0.871387283236994
RC2_0088_ICR-3_p08,0.862061774729362,677,690,95,595,0.86231884057971
RC2_0089_ICR-1_p08,0.868072365633325,639,646,85,561,0.868421052631579
RC2_0089_ICR-2_p08,0.871112848909923,598,606,98,508,0.838283828382838
RC2_0089_ICR-3_p08,0.865584209372225,614,624,82,542,0.868589743589744
RC2_0090_ICR-1_p08,0.86023765925997,595,606,80,526,0.867986798679868
RC2_0090_ICR-2_p08,0.850446802144338,605,608,83,525,0.863486842105263
RC2_0090_ICR-3_p08,0.895218944142548,635,645,91,554,0.858914728682171
RC2_0091_ICR-1_p1,0.644135673004804,435,436,43,393,0.901376146788991
RC2_0091_ICR-2_p1,0.59861785857117,400,401,28,373,0.930174563591022
RC2_0091_ICR-3_p1,0.710909335601083,434,435,32,403,0.926436781609195
RC2_0092_ICR-1_p1,0.775626116746516,553,554,41,513,0.925992779783393
RC2_0092_ICR-2_p1,0.830964009621052,595,596,59,537,0.901006711409396
RC2_0092_ICR-3_p1,0.802279205756033,565,566,40,526,0.929328621908127
RC2_0093_ICR-1_p1,0.807051389908425,623,625,66,559,0.8944
RC2_0093_ICR-2_p1,0.833277651286401,647,650,70,580,0.892307692307692
RC2_0093_ICR-3_p1,0.767985762503709,613,614,98,516,0.840390879478827
RC2_0094_ICR-1_p1,0.866203581053296,644,651,87,564,0.866359447004608
RC2_0094_ICR-2_p1,0.833952325819949,606,608,53,555,0.912828947368421
RC2_0094_ICR-3_p1,0.830646993365908,643,650,88,562,0.864615384615385
RC2_0095_ICR-1_p1,0.772387372135878,558,561,70,491,0.875222816399287
RC2_0095_ICR-2_p1,0.827908213950454,590,592,72,520,0.878378378378378
RC2_0095_ICR-3_p1,0.810114822549383,589,590,94,496,0.840677966101695
RC2_0096_ICR-1_p1,0.351690858994892,529,531,49,482,0.907721280602637
RC2_0096_ICR-2_p1,0.864520440881998,581,586,85,501,0.854948805460751
RC2_0096_ICR-3_p1,0.762872395379675,570,570,76,494,0.866666666666667
RC2_0097_ICR-1_p1,0.80622893990836,590,594,100,494,0.831649831649832
RC2_0097_ICR-2_p1,0.761394921249733,581,584,83,501,0.857876712328767
RC2_0097_ICR-3_p1,0.694760818256451,506,507,33,474,0.93491124260355
RC2_0098_ICR-1_p1,0.82187411691117,587,591,75,516,0.873096446700508
RC2_0098_ICR-2_p1,0.822066326700743,621,625,98,527,0.8432
RC2_0098_ICR-3_p1,0.834292084952905,582,590,72,518,0.877966101694915
RC2_0099_ICR-1_p1,0.860583156087171,679,687,96,591,0.860262008733624
RC2_0099_ICR-2_p1,0.796821801254562,588,593,48,545,0.919055649241147
RC2_0099_ICR-3_p1,0.70738540544722,626,627,67,560,0.893141945773525
RC2_0100_ICR-1_p1,0.835539182987048,611,625,97,528,0.8448
RC2_0100_ICR-2_p1,0.844171088213004,680,683,80,603,0.882869692532943
RC2_0100_ICR-3_p1,0.704285667962587,642,644,69,575,0.892857142857143
RC2_0101_ICR-1_p1,0.0548039415405275,380,380,33,347,0.913157894736842
RC2_0101_ICR-2_p3,0.830602625299141,440,442,61,381,0.861990950226244
RC2_0101_ICR-3_p1,0.583179155119658,459,462,33,429,0.928571428571429
RC2_0103_ICR-1_p1,0.511922702127795,582,584,59,525,0.898972602739726
RC2_0103_ICR-2_p1,0.68516370220265,614,619,70,549,0.886914378029079
RC2_0103_ICR-3_p1,0.846948660255069,671,682,97,585,0.857771260997067
RC2_0104_ICR-1_p1,0.83845737696264,602,602,63,539,0.895348837209302
RC2_0104_ICR-2_p1,0.732538244400673,557,559,45,514,0.919499105545617
RC2_0104_ICR-3_p1,0.828331735758247,600,602,60,542,0.900332225913621
RC2_0105_ICR-1_p1,0.851402932016548,614,616,88,528,0.857142857142857
RC2_0105_ICR-2_p1,0.851977062654706,630,646,98,548,0.848297213622291
RC2_0105_ICR-3_p1,0.832474387285302,617,621,74,547,0.880837359098229
RC2_0106_ICR-1_p1,0.712552606711823,572,575,61,514,0.893913043478261
RC2_0106_ICR-2_p1,0.704875026444166,571,571,61,510,0.893169877408056
RC2_0106_ICR-3_p1,0.774805315403675,566,568,82,486,0.855633802816901
RC2_0107_ICR-1_p3,0.797090335905768,302,307,62,245,0.798045602605863
RC2_0107_ICR-2_p1,0.758479211226203,431,432,44,388,0.898148148148148
RC2_0107_ICR-3_p1,0.609956341800898,458,459,50,409,0.891067538126362
RC2_0108_ICR-1_p1,0.824260821353247,627,628,82,546,0.869426751592357
RC2_0108_ICR-2_p1,0.825671608476915,587,591,76,515,0.871404399323181
RC2_0108_ICR-3_p1,0.852467306114915,602,608,74,534,0.878289473684211
RC2_0109_ICR-1_p1,0.806717499208231,629,633,76,557,0.879936808846761
RC2_0109_ICR-2_p1,0.838128384287269,657,664,69,595,0.896084337349398
RC2_0109_ICR-3_p1,0.800433203542295,622,624,52,572,0.916666666666667
RC2_0110_ICR-1_p1,0.801892008840049,609,611,94,517,0.846153846153846
RC2_0110_ICR-2_p1,0.821924825533566,569,570,42,528,0.926315789473684
RC2_0110_ICR-3_p1,0.816718279111648,644,647,84,563,0.870170015455951
RC2_0111_ICR-1_p1,0.668572446717457,528,532,43,489,0.919172932330827
RC2_0111_ICR-2_p1,0.770428301154662,548,549,56,493,0.89799635701275
RC2_0111_ICR-3_p1,0.800540086241084,548,549,41,508,0.925318761384335
RC2_0112_ICR-1_p1,0.792051753155452,541,542,46,496,0.915129151291513
RC2_0112_ICR-2_p1,0.856031505817415,607,614,93,521,0.848534201954397
RC2_0112_ICR-3_p1,0.808917692254903,582,586,66,520,0.887372013651877
RC2_0113_ICR-1_p3,0.843197163146413,517,522,83,439,0.840996168582375
RC2_0113_ICR-2_p1,0.582294322338782,485,487,49,438,0.899383983572895
RC2_0113_ICR-3_p1,0.71999811203094,514,519,54,465,0.895953757225434
RC2_0114_ICR-1_p1,0.827296387402309,614,617,62,555,0.899513776337115
RC2_0114_ICR-2_p1,0.650189076919992,541,543,47,496,0.913443830570902
RC2_0114_ICR-3_p1,0.831362387490489,559,560,45,515,0.919642857142857
RC2_0115_ICR-1_p1,0.836463281498789,647,652,77,575,0.881901840490798
RC2_0115_ICR-2_p1,0.780206060808489,586,586,51,535,0.912969283276451
RC2_0115_ICR-3_p1,0.621120563643599,549,553,46,507,0.916817359855335
RC2_0116_ICR-1_p1,0.798182103478901,568,569,55,514,0.903339191564148
RC2_0116_ICR-2_p1,0.728896486597076,497,497,70,427,0.859154929577465
RC2_0116_ICR-3_p1,0.761842625858885,542,546,46,500,0.915750915750916
RC2_0117_ICR-1_p1,0.77244156578718,570,571,74,497,0.870402802101576
RC2_0117_ICR-2_p1,0.698421839721661,581,583,69,514,0.881646655231561
RC2_0117_ICR-3_p1,0.756439782245647,586,586,92,494,0.843003412969283
RC2_0118_ICR-1_p1,0.700979232797142,500,501,35,466,0.930139720558882
RC2_0118_ICR-2_p1,0.691901682176203,530,531,52,479,0.902071563088512
RC2_0118_ICR-3_p1,0.806529480798916,537,539,54,485,0.899814471243043
RC2_0119_ICR-1_p1,0.675067154733684,479,481,55,426,0.885654885654886
RC2_0119_ICR-2_p1,0.705916334467695,483,485,54,431,0.888659793814433
RC2_0119_ICR-3_p1,0.781513334514685,464,466,46,420,0.901287553648069
RC2_0120_ICR-1_p1,0.668500255075221,577,579,64,515,0.889464594127807
RC2_0120_ICR-2_p1,0.742876906799217,558,560,61,499,0.891071428571429
RC2_0120_ICR-3_p1,0.870028821446263,628,632,89,543,0.859177215189873
RC2_0121_ICR-1_p1,0.794270168219524,622,625,65,560,0.896
RC2_0121_ICR-2_p1,0.846638895004364,655,665,93,572,0.86015037593985
RC2_0121_ICR-3_p1,0.804288365061732,577,579,50,529,0.913644214162349
RC2_0122_ICR-1_p1,0.807813429176339,562,563,47,516,0.91651865008881
RC2_0122_ICR-2_p1,0.846855201902384,629,632,87,545,0.862341772151899
RC2_0122_ICR-3_p1,0.78465238447898,547,551,81,470,0.852994555353902
RC2_0123_ICR-1_p1,0.779415225402004,574,574,90,484,0.843205574912892
RC2_0123_ICR-2_p1,0.803245360760193,598,600,107,493,0.821666666666667
RC2_0123_ICR-3_p1,0.648931682644076,526,527,50,477,0.905123339658444
RC2_0124_ICR-1_p1,0.85717757351623,586,594,104,490,0.824915824915825
RC2_0124_ICR-2_p1,0.779268709943799,528,529,46,483,0.91304347826087
RC2_0124_ICR-3_p1,0.859736498417316,603,609,82,527,0.865353037766831
RC2_0125_ICR-1_p1,0.767075178450747,490,491,47,444,0.904276985743381
RC2_0125_ICR-2_p1,0.694901935915423,485,487,48,439,0.901437371663244
RC2_0125_ICR-3_p1,0.789668013160485,504,506,53,453,0.895256916996047
RC2_0126_ICR-1_p1,0.814692781353284,544,545,41,504,0.924770642201835
RC2_0126_ICR-2_p3,0.81643954924646,405,411,66,345,0.839416058394161
RC2_0127_ICR-1_p1,0.532539440155705,550,551,44,507,0.920145190562613
RC2_0127_ICR-2_p1,0.850393827269155,657,671,97,574,0.855439642324888
RC2_0127_ICR-3_p1,0.735745426629571,601,604,101,503,0.832781456953642
RC2_0128_ICR-1_p1,0.792000257338219,551,552,50,502,0.909420289855073
RC2_0128_ICR-2_p1,0.842276394654598,635,641,80,561,0.875195007800312
RC2_0128_ICR-3_p1,0.789104135474074,552,553,45,508,0.918625678119349
RC2_0129_ICR-1_p1,0.752946722840766,540,541,48,493,0.911275415896488
RC2_0129_ICR-2_p1,0.79062219748913,534,534,51,483,0.904494382022472
RC2_0129_ICR-3_p1,0.875951170371582,554,556,131,425,0.764388489208633
RC2_0130_ICR-1_p1,0.833515361466239,575,577,84,493,0.854419410745234
RC2_0130_ICR-2_p1,0.85254502145418,579,588,111,477,0.811224489795918
RC2_0130_ICR-3_p1,0.868236979468297,570,574,72,502,0.874564459930314
RC2_0131_ICR-1_p1,0.348442317824778,501,504,69,435,0.863095238095238
RC2_0131_ICR-2_p1,0.396876208142913,467,468,44,424,0.905982905982906
RC2_0131_ICR-3_p1,0.580083000940408,388,389,34,355,0.912596401028278
RC2_0132_ICR-1_p1,0.730894324004297,593,595,66,529,0.889075630252101
RC2_0132_ICR-2_p1,0.825096633112485,574,577,56,521,0.902946273830156
RC2_0132_ICR-3_p1,0.844058721803811,616,617,59,558,0.904376012965964
RC2_0133_ICR-1_p1,0.716398185420481,500,502,35,467,0.930278884462151
RC2_0133_ICR-2_p1,0.777503205296859,608,611,66,545,0.891980360065466
RC2_0133_ICR-3_p1,0.650824447914707,557,558,43,515,0.922939068100358
RC2_0134_ICR-1_p1,0.763753777663832,537,538,39,499,0.927509293680297
RC2_0134_ICR-2_p1,0.787704090673221,548,548,55,493,0.89963503649635
RC2_0134_ICR-3_p1,0.81104813181562,606,608,70,538,0.884868421052632
RC2_0135_ICR-1_p1,0.859397026576078,560,563,94,469,0.83303730017762
RC2_0135_ICR-2_p1,0.821753896109244,547,551,52,499,0.90562613430127
RC2_0135_ICR-3_p1,0.863872584010858,601,606,82,524,0.864686468646865
RC2_0136_ICR-1_p1,0.838700432937753,573,578,84,494,0.854671280276817
RC2_0136_ICR-2_p1,0.840133976209269,561,571,79,492,0.861646234676007
RC2_0136_ICR-3_p1,0.875105372582312,575,580,125,455,0.78448275862069
RC2_0137_ICR-1_p1,0.677439460776591,560,563,42,521,0.925399644760213
RC2_0137_ICR-2_p1,0.793753270344505,576,579,49,530,0.915371329879102
RC2_0137_ICR-3_p1,0.854379893052505,650,655,78,577,0.880916030534351
RC2_0138_ICR-1_p1,0.847523113572777,701,701,100,601,0.85734664764622
RC2_0138_ICR-2_p1,0.862767424970569,681,686,96,590,0.860058309037901
RC2_0138_ICR-3_p1,0.877691180769854,719,720,112,608,0.844444444444444
RC2_0139_ICR-1_p1,0.816827262126259,670,671,78,593,0.883755588673621
RC2_0139_ICR-2_p1,0.744448454161117,607,607,52,555,0.914332784184514
RC2_0139_ICR-3_p1,0.769113104698127,611,615,54,561,0.91219512195122
RC2_0140_ICR-1_p1,0.771704495891956,526,529,44,485,0.916824196597353
RC2_0140_ICR-2_p1,0.793202449591794,619,620,90,530,0.854838709677419
RC2_0140_ICR-3_p1,0.822257859562917,613,616,69,547,0.887987012987013
RC2_0141_ICR-1_p1,0.799546825996017,592,592,83,509,0.859797297297297
RC2_0141_ICR-2_p1,0.741925260716227,584,584,90,494,0.845890410958904
RC2_0141_ICR-3_p1,0.792970918060871,580,581,99,482,0.82960413080895
RC2_0142_ICR-1_p1,0.836681945357903,587,592,69,523,0.883445945945946
RC2_0142_ICR-2_p1,0.824708286110416,558,563,68,495,0.879218472468916
RC2_0142_ICR-3_p1,0.84144474404231,572,574,59,515,0.897212543554007
RC2_0143_ICR-1_p1,0.790509828836245,654,656,62,594,0.905487804878049
RC2_0143_ICR-2_p1,0.681164774529951,629,630,59,571,0.906349206349206
RC2_0143_ICR-3_p1,0.826341250248553,684,686,88,598,0.871720116618076
RC2_0144_ICR-1_p1,0.896335560433983,701,706,98,608,0.861189801699717
RC2_0144_ICR-2_p1,0.88950649573138,720,727,106,621,0.854195323246217
RC2_0144_ICR-3_p1,0.886354088815856,722,731,126,605,0.827633378932969
RC2_0145_ICR-1_p1,0.847271234925006,676,680,88,592,0.870588235294118
RC2_0145_ICR-2_p1,0.854018330330846,692,698,98,600,0.859598853868195
RC2_0145_ICR-3_p1,0.758586137241307,633,635,68,567,0.892913385826772
RC2_0146_ICR-1_p1,0.756791500175749,516,516,40,476,0.922480620155039
RC2_0146_ICR-2_p1,0.842045445827545,629,635,98,537,0.845669291338583
RC2_0146_ICR-3_p1,0.811959952306075,625,631,98,533,0.844690966719493
RC2_0147_ICR-1_p1,0.845887990028101,595,596,89,507,0.850671140939597
RC2_0147_ICR-2_p1,0.797390549203332,566,569,76,493,0.866432337434095
RC2_0147_ICR-3_p1,0.708609816847553,533,534,46,488,0.913857677902622
RC2_0148_ICR-1_p1,0.83016405379482,637,639,116,523,0.818466353677621
RC2_0148_ICR-2_p1,0.775238623764765,556,557,46,511,0.917414721723519
RC2_0148_ICR-3_p1,0.856834191977833,601,605,72,533,0.88099173553719
RC2_0149_ICR-1_p08,0.903559694648546,624,636,53,583,0.916666666666667
RC2_0149_ICR-2_p08,0.90146563480071,607,615,52,563,0.915447154471545
RC2_0149_ICR-3_p08,0.901416158652745,656,667,75,592,0.887556221889055
RC2_0150_ICR-1_p08,0.873629219935646,620,624,56,568,0.91025641025641
RC2_0150_ICR-2_p08,0.895632891755429,625,629,60,569,0.904610492845787
RC2_0150_ICR-3_p08,0.897328973361984,674,676,63,613,0.906804733727811
RC2_0151_ICR-1_p1,0.67089154734055,326,329,53,276,0.838905775075988
RC2_0151_ICR-1_p08,0.445639091593006,294,296,40,256,0.864864864864865
RC2_0151_ICR-2_p08,0.887961245989528,693,697,77,620,0.889526542324247
RC2_0151_ICR-3_p08,0.899334374777017,622,635,57,578,0.910236220472441
RC2_0152_ICR-1_p08,0.897764787861015,612,632,63,569,0.900316455696203
RC2_0152_ICR-2_p08,0.877467197464575,647,650,89,561,0.863076923076923
RC2_0152_ICR-3_p08,0.871648417001343,659,663,74,589,0.888386123680241
RC2_0153_ICR-2_p08,0.891727097067303,643,651,65,586,0.900153609831029
RC2_0153_ICR-3_p08,0.885622820564207,653,662,64,598,0.903323262839879
RC2_0154_ICR-1_p08,0.887119205120735,639,647,71,576,0.890262751159196
RC2_0154_ICR-2_p08,0.886881319391129,621,627,63,564,0.899521531100478
RC2_0154_ICR-3_p08,0.887540319157553,612,626,53,573,0.915335463258786
RC2_0155_ICR-1_p08,0.902633021681799,627,633,67,566,0.894154818325434
RC2_0155_ICR-2_p08,0.842401050140163,578,582,59,523,0.898625429553265
RC2_0155_ICR-3_p08,0.894005618861179,624,627,56,571,0.910685805422648
RC2_0156_ICR-1_p08,0.894131775923546,646,652,72,580,0.889570552147239
RC2_0156_ICR-2_p08,0.891453870232402,593,601,58,543,0.903494176372712
RC2_0156_ICR-3_p08,0.88301932896274,567,573,44,529,0.923211169284468
RC2_0157_ICR-1_p08,0.875317403029574,630,633,67,566,0.894154818325434
RC2_0157_ICR-2_p08,0.900768381718961,644,646,61,585,0.905572755417957
RC2_0157_ICR-3_p08,0.904010379841798,639,652,62,590,0.904907975460123
RC2_0158_ICR-1_p08,0.902126286290832,602,605,50,555,0.917355371900826
RC2_0158_ICR-2_p08,0.900687942926273,655,661,69,592,0.895612708018154
RC2_0158_ICR-3_p08,0.885024580811027,610,618,61,557,0.901294498381877
RC2_0159_ICR-1_p08,0.903330408481123,615,622,44,578,0.929260450160772
RC2_0159_ICR-2_p08,0.89731370781651,613,619,54,565,0.912762520193861
RC2_0159_ICR-3_p08,0.896778131492786,624,629,61,568,0.90302066772655
RC2_0160_ICR-1_p08,0.896362323355601,635,639,57,582,0.910798122065728
RC2_0160_ICR-2_p08,0.895619696376137,569,575,48,527,0.916521739130435
RC2_0160_ICR-3_p08,0.885767683920793,636,642,52,590,0.919003115264797
RC2_0163_ICR-1_p08,0.868689544470914,654,662,65,597,0.901812688821752
RC2_0163_ICR-2_p08,0.876632405897926,650,658,82,576,0.875379939209726
RC2_0163_ICR-3_p08,0.892773556229289,663,674,74,600,0.890207715133531
RC2_0164_ICR-1_p08,0.882294551133314,621,629,71,558,0.887122416534181
RC2_0164_ICR-2_p08,0.807483533832837,531,534,39,495,0.926966292134832
RC2_0164_ICR-3_p08,0.886866535358528,600,604,56,548,0.907284768211921
RC2_0165_ICR-1_p08,0.888324735080994,585,592,51,541,0.913851351351351
RC2_0165_ICR-2_p08,0.901021376069214,599,611,54,557,0.911620294599018
RC2_0165_ICR-3_p08,0.885910597372494,570,577,59,518,0.897746967071057
RC2_0166_ICR-1_p08,0.896140226726821,568,572,49,523,0.914335664335664
RC2_0166_ICR-2_p08,0.867175554231535,594,599,60,539,0.89983305509182
RC2_0166_ICR-3_p08,0.735444967105715,448,453,50,403,0.88962472406181
RC2_0167_ICR-1_p08,0.746751566223218,389,393,68,325,0.826972010178117
RC2_0167_ICR-2_p08,0.814201201570234,542,546,61,485,0.888278388278388
RC2_0167_ICR-3_p08,0.850491158716538,532,538,65,473,0.879182156133829
RC2_0177_ICR-1_p08,0.873025247010963,556,562,50,512,0.911032028469751
RC2_0177_ICR-2_p08,0.876046305649495,634,640,65,575,0.8984375
RC2_0177_ICR-3_p08,0.875353530339929,607,613,60,553,0.902120717781403
RC2_0178_ICR-1_p08,0.817615342016703,539,542,52,490,0.904059040590406
RC2_0178_ICR-2_p08,0.894841068512458,588,593,49,544,0.917369308600337
RC2_0178_ICR-3_p08,0.87793940804438,573,583,54,529,0.9073756432247
RC2_0179_ICR-1_p08,0.895147287940558,643,651,61,590,0.906298003072197
RC2_0179_ICR-3_p08,0.900916288708035,617,621,63,558,0.898550724637681
RC2_0183_ICR-2_p08,0.87898329435959,583,587,53,534,0.909710391822828
RC2_0183_ICR-3_p08,0.896796496235947,611,617,54,563,0.912479740680713
RC2_0184_ICR-1_p08,0.889843648412186,612,619,61,558,0.901453957996769
RC2_0184_ICR-2_p08,0.867807213432251,577,581,49,532,0.91566265060241
RC2_0184_ICR-3_p08,0.894812880714816,599,606,48,558,0.920792079207921
RC2_0187_ICR-1_p08,0.876295167295965,642,649,80,569,0.87673343605547
RC2_0187_ICR-2_p08,0.887223853733867,656,662,81,581,0.877643504531722
RC2_0187_ICR-3_p08,0.887373109498619,637,645,78,567,0.87906976744186
RC2_0188_ICR-1_p08,0.822750185578805,562,574,73,501,0.872822299651568
RC2_0188_ICR-2_p08,0.878017582135622,594,603,57,546,0.90547263681592
RC2_0188_ICR-3_p08,0.870439601970997,600,611,71,540,0.88379705400982
RC2_0189_ICR-1_p08,0.898033324909192,602,611,53,558,0.913256955810147
RC2_0189_ICR-2_p08,0.897114103022384,615,626,61,565,0.902555910543131
RC2_0189_ICR-3_p08,0.858999063480804,620,626,76,550,0.878594249201278
RC2_0190_ICR-1_p08,0.852463471894613,601,604,62,542,0.897350993377483
RC2_0190_ICR-2_p08,0.893680155315927,611,622,55,567,0.911575562700965
RC2_0190_ICR-3_p08,0.868308657040071,588,594,64,530,0.892255892255892
RC2_0191_ICR-1_p08,0.869393273620752,601,603,61,542,0.898839137645108
RC2_0191_ICR-2_p08,0.867601233215519,616,616,69,547,0.887987012987013
RC2_0191_ICR-3_p08,0.85556825656544,570,571,46,525,0.919439579684764
RC2_0192_ICR-1_p08,0.862121903391235,579,586,61,525,0.895904436860068
RC2_0192_ICR-2_p1,0.728375062311664,358,363,42,321,0.884297520661157
RC2_0192_ICR-3_p08,0.882195070600546,591,598,62,536,0.896321070234114
RC2_0193_ICR-1_p08,0.89209572208624,676,689,83,606,0.879535558780842
RC2_0193_ICR-2_p08,0.891200363603289,718,736,99,637,0.865489130434783
RC2_0193_ICR-3_p08,0.897246203097698,664,686,84,602,0.877551020408163
RC2_0194_ICR-1_p08,0.860215917775427,560,569,73,496,0.87170474516696
RC2_0194_ICR-2_p08,0.893587608365712,649,667,59,608,0.911544227886057
RC2_0194_ICR-3_p08,0.904420143401518,685,705,87,618,0.876595744680851
RC2_0195_ICR-1_p08,0.895386839912848,672,679,81,598,0.880706921944035
RC2_0195_ICR-2_p08,0.900274821526749,577,584,58,526,0.900684931506849
RC2_0195_ICR-3_p08,0.894667049774484,619,624,56,568,0.91025641025641
RC2_0196_ICR-1_p08,0.90523624716411,634,642,52,590,0.919003115264797
RC2_0196_ICR-2_p08,0.905825560768729,632,646,54,592,0.91640866873065
RC2_0196_ICR-3_p08,0.849019085445134,543,547,50,497,0.908592321755027
RC2_0197_ICR-1_p08,0.882931963002917,615,618,48,570,0.922330097087379
RC2_0197_ICR-2_p08,0.888151837356919,622,631,60,571,0.904912836767036
RC2_0197_ICR-3_p08,0.891131049673346,647,656,78,578,0.88109756097561
RC2_0198_ICR-1_p08,0.885367516981773,671,675,79,596,0.882962962962963
RC2_0198_ICR-2_p08,0.898639537245725,611,622,59,563,0.905144694533762
RC2_0198_ICR-3_p08,0.874269685263211,622,626,64,562,0.89776357827476
RC2_0199_ICR-1_p08,0.903547928874767,665,676,77,599,0.886094674556213
RC2_0199_ICR-2_p08,0.889374404903567,673,675,69,606,0.897777777777778
RC2_0199_ICR-3_p08,0.898933228611345,619,628,63,565,0.89968152866242
RC2_0200_ICR-1_p08,0.890108541356325,496,509,38,471,0.925343811394892
RC2_0200_ICR-2_p08,0.899561912775941,488,514,51,463,0.900778210116732
RC2_0200_ICR-3_p08,0.897251252769034,503,525,49,476,0.906666666666667
RC2_0201_ICR-1_p08,0.89635363566012,486,516,50,466,0.903100775193798
RC2_0201_ICR-2_p08,0.839787933708665,401,409,35,374,0.914425427872861
RC2_0201_ICR-3_p08,0.868755533557406,439,461,43,418,0.906724511930586
RC2_0202_ICR-1_p08,0.853850425116128,419,439,47,392,0.892938496583144
RC2_0202_ICR-2_p08,0.890573605871076,486,511,51,460,0.900195694716243
RC2_0202_ICR-3_p08,0.894409851699869,482,505,49,456,0.902970297029703
RC2_0203_ICR-1_p08,0.898068944944052,504,534,60,474,0.887640449438202
RC2_0203_ICR-2_p08,0.882063402299968,465,486,47,439,0.903292181069959
RC2_0203_ICR-3_p08,0.881254950389913,469,495,51,444,0.896969696969697
RC2_0204_ICR-1_p08,0.878176137408355,473,496,45,451,0.909274193548387
RC2_0204_ICR-2_p08,0.852581663949009,455,470,39,431,0.917021276595745
RC2_0204_ICR-3_p08,0.872346132130115,468,498,55,443,0.889558232931727
RC2_0205_ICR-1_p08,0.859217372327124,475,503,59,444,0.882703777335984
RC2_0205_ICR-2_p08,0.847505881515671,425,440,45,395,0.897727272727273
RC2_0205_ICR-3_p08,0.843244871250223,430,442,39,403,0.911764705882353
RC2_0206_ICR-1_p08,0.902352193967936,507,520,40,480,0.923076923076923
RC2_0206_ICR-2_p08,0.906721840023298,495,504,38,466,0.924603174603175
RC2_0206_ICR-3_p08,0.903191173556416,511,518,37,481,0.928571428571429
RC2_0207_ICR-1_p08,0.877625992456133,436,458,43,415,0.906113537117904
RC2_0207_ICR-2_p08,0.89775506158647,477,498,46,452,0.907630522088353
RC2_0207_ICR-3_p08,0.865858341163696,426,436,35,401,0.919724770642202
RC2_0208_ICR-1_p08,0.872856264687517,468,496,56,440,0.887096774193548
RC2_0208_ICR-2_p08,0.893060033213367,494,516,44,472,0.914728682170543
RC2_0208_ICR-3_p08,0.896798637829411,516,547,61,486,0.888482632541133
RC2_0209_ICR-1_p08,0.864927955403165,451,476,59,417,0.876050420168067
RC2_0209_ICR-2_p08,0.891496313809157,477,498,49,449,0.901606425702811
RC2_0209_ICR-3_p08,0.872653510189432,457,482,51,431,0.894190871369295
RC2_0210_ICR-1_p08,0.857406011948001,440,467,48,419,0.897216274089936
RC2_0210_ICR-2_p08,0.846832714703134,434,456,50,406,0.890350877192982
RC2_0210_ICR-3_p08,0.887400337822889,481,507,56,451,0.889546351084813
RC2_0211_ICR-1_p08,0.871087647273182,464,481,51,430,0.893970893970894
RC2_0211_ICR-2_p08,0.874051431235183,488,512,48,464,0.90625
RC2_0211_ICR-3_p08,0.869724131124318,466,487,44,443,0.909650924024641
WROL2019_001_ICR-1_p08,0.922980176767033,451,456,19,437,0.958333333333333
WROL2019_001_ICR-2_p1,0.922862975456277,319,333,69,264,0.792792792792793
WROL2019_001_ICR-3_p08,0.946461435803124,460,464,15,449,0.967672413793103
WROL2019_002_ICR-1_p1,0.569935394236102,48,48,3,45,0.9375
WROL2019_002_ICR-2_p08,0.753415906239444,149,149,9,140,0.939597315436242
WROL2019_002_ICR-3_p08,0.758639651142654,142,144,19,125,0.868055555555556
WROL2019_003_ICR-1_p08,0.914215670175236,223,223,14,209,0.937219730941704
WROL2019_003_ICR-2_p08,0.937722815594468,235,236,20,216,0.915254237288136
WROL2019_003_ICR-3_p08,0.917188899084292,303,313,33,280,0.894568690095847
WROL2019_004_ICR-1_p08,0.947866931442919,637,642,42,600,0.934579439252336
WROL2019_004_ICR-2_p08,0.960909537422698,532,542,24,518,0.955719557195572
WROL2019_004_ICR-3_p08,0.953878839430167,667,674,38,636,0.943620178041543
WROL2019_005_ICR-1_p08,0.916488078490513,453,457,12,445,0.973741794310722
WROL2019_005_ICR-2_p08,0.93412070299883,518,524,19,505,0.963740458015267
WROL2019_005_ICR-3_p08,0.943579482595154,629,636,25,611,0.960691823899371
WROL2019_006_ICR-1_p08,0.905875512202622,187,187,13,174,0.93048128342246
WROL2019_006_ICR-2_p1,0.833141241974685,251,255,20,235,0.92156862745098
WROL2019_006_ICR-3_p08,0.860560812025679,264,267,22,245,0.917602996254682
WROL2019_007_ICR-1_p08,0.850448373708212,261,264,6,258,0.977272727272727
WROL2019_007_ICR-2_p08,0.929120217100105,457,464,25,439,0.946120689655172
WROL2019_007_ICR-3_p08,0.923583267037916,335,337,16,321,0.952522255192878
WROL2019_008_ICR-1_p08,0.884068350351124,350,355,17,338,0.952112676056338
WROL2019_008_ICR-2_p08,0.93675858737352,473,480,23,457,0.952083333333333
WROL2019_008_ICR-3_p08,0.917927121694681,382,384,10,374,0.973958333333333
WROL2019_009_ICR-1_p08,0.841049956015172,252,254,14,240,0.94488188976378
WROL2019_009_ICR-2_p08,0.945882750468159,545,548,14,534,0.974452554744526
WROL2019_009_ICR-3_p08,0.946540712583381,488,492,17,475,0.965447154471545
WROL2019_010_ICR-1_p08,0.963625456485101,607,639,67,572,0.895148669796557
WROL2019_010_ICR-2_p08,0.938823183121943,655,668,55,613,0.917664670658683
WROL2019_010_ICR-3_p08,0.886860917540013,305,306,4,302,0.986928104575163
WROL2019_011_ICR-1_p08,0.941541879303738,584,591,44,547,0.925549915397631
WROL2019_011_ICR-2_p08,0.947950160362692,597,601,54,547,0.910149750415973
WROL2019_011_ICR-3_p08,0.904121851180034,318,319,14,305,0.956112852664577
WROL2019_012_ICR-1_p08,0.941303767952187,462,479,38,441,0.920668058455115
WROL2019_012_ICR-2_p08,0.94622940963836,551,559,88,471,0.84257602862254
WROL2019_012_ICR-3_p08,0.960783637739296,657,668,37,631,0.944610778443114
WROL2019_013_ICR-1_p08,0.93165307574266,277,281,23,258,0.918149466192171
WROL2019_013_ICR-3_p08,0.849024455601904,247,250,34,216,0.864
WROL2019_014_ICR-1_p08,0.878132603530637,341,347,19,328,0.945244956772334
WROL2019_014_ICR-2_p08,0.879758607666909,344,352,25,327,0.928977272727273
WROL2019_014_ICR-3_p08,0.917317604731893,446,455,26,429,0.942857142857143
WROL2019_015_ICR-1_p1,0.881313247390159,24,24,2,22,0.916666666666667
WROL2019_015_ICR-2_p08,0.9043820490683,365,376,42,334,0.888297872340426
WROL2019_015_ICR-3_p08,0.871398072829697,324,334,36,298,0.892215568862275
WROL2019_016_ICR-1_p08,0.920374263678437,360,367,16,351,0.956403269754768
WROL2019_016_ICR-2_p08,0.928140891967825,464,481,44,437,0.908523908523909
WROL2019_016_ICR-3_p08,0.946720689362519,534,550,30,520,0.945454545454545
WROL2019_017_ICR-1_p08,0.914613037805775,374,385,26,359,0.932467532467532
WROL2019_017_ICR-2_p08,0.827627687893589,209,211,10,201,0.95260663507109
WROL2019_017_ICR-3_p08,0.886541634255998,324,331,30,301,0.909365558912387
WROL2019_018_ICR-1_p08,0.931475797547199,494,502,20,482,0.960159362549801
WROL2019_018_ICR-2_p08,0.948713004299378,558,573,32,541,0.944153577661431
WROL2019_018_ICR-3_p08,0.928479623703221,406,413,17,396,0.958837772397094
WROL2019_019_ICR-1_p08,0.949497641971248,586,601,33,568,0.945091514143095
WROL2019_019_ICR-2_p08,0.963618258991297,550,572,48,524,0.916083916083916
WROL2019_019_ICR-3_p08,0.930331516445157,479,492,33,459,0.932926829268293
WROL2019_020_ICR-1_p08,0.933760655869372,454,464,23,441,0.950431034482759
WROL2019_020_ICR-2_p08,0.937360451841102,541,563,47,516,0.91651865008881
WROL2019_020_ICR-3_p08,0.852025806119022,319,327,27,300,0.917431192660551
WROL2019_021_ICR-1_p08,0.939792065798553,520,531,29,502,0.945386064030132
WROL2019_021_ICR-2_p08,0.928276427769657,431,445,40,405,0.910112359550562
WROL2019_021_ICR-3_p08,0.907020610482587,379,385,19,366,0.950649350649351
WROL2019_022_ICR-1_p08,0.755676189815567,184,186,11,175,0.940860215053763
WROL2019_022_ICR-2_p08,0.907851374419358,341,353,42,311,0.881019830028329
WROL2019_022_ICR-3_p08,0.924949531136606,275,277,12,265,0.956678700361011
WROL2019_023_ICR-2_p08,0.955090580992937,657,668,61,607,0.908682634730539
WROL2019_023_ICR-3_p08,0.930618368846517,489,500,29,471,0.942
WROL2019_024_ICR-1_p08,0.803196309497211,177,178,7,171,0.960674157303371
WROL2019_024_ICR-2_p1,0.678953523924847,29,29,4,25,0.862068965517241
WROL2019_024_ICR-3_p1,0.797550999155159,197,198,15,183,0.924242424242424
WROL2019_025_ICR-1_p1,0.811423462709854,118,118,23,95,0.805084745762712
WROL2019_025_ICR-2_p1,0.81598542179416,169,169,24,145,0.857988165680473
WROL2019_025_ICR-3_p08,0.812581759151573,100,100,10,90,0.9
WROL2019_026_ICR-1_p08,0.752657149559864,120,120,4,116,0.966666666666667
WROL2019_026_ICR-2_p1,0.723432339403211,147,150,17,133,0.886666666666667
WROL2019_026_ICR-3_p08,0.838837331968088,172,173,14,159,0.919075144508671
WROL2019_029_ICR-1_p08,0.816212124272042,213,214,12,202,0.94392523364486
WROL2019_029_ICR-2_p1,0.750025920804721,184,186,19,167,0.897849462365591
WROL2019_029_ICR-3_p08,0.889651792890788,335,338,17,321,0.949704142011834
WROL2019_030_ICR-1_p08,0.862336504435198,271,273,16,257,0.941391941391941
WROL2019_030_ICR-2_p08,0.92783203344261,391,393,28,365,0.928753180661578
WROL2019_030_ICR-3_p08,0.912693264487631,427,435,20,415,0.954022988505747
WROL2019_033_ICR-1_p1,0.830075386603594,194,195,10,185,0.948717948717949
WROL2019_033_ICR-2_p08,0.691728469066565,159,159,9,150,0.943396226415094
WROL2019_033_ICR-3_p08,0.917576840330827,347,351,12,339,0.965811965811966
WROL2019_034_ICR-1_p1,0.851993056130949,265,269,13,256,0.951672862453532
WROL2019_034_ICR-2_p08,0.868118082812285,201,202,8,194,0.96039603960396
WROL2019_034_ICR-3_p08,0.951619383736727,368,375,22,353,0.941333333333333
WROL2019_035_ICR-1_p08,0.94126105915883,538,548,30,518,0.945255474452555
WROL2019_035_ICR-2_p08,0.777150178807232,214,216,7,209,0.967592592592593
WROL2019_035_ICR-3_p08,0.929618462938409,424,426,14,412,0.967136150234742
WROL2019_036_ICR-1_p08,0.895177222014518,336,339,12,327,0.964601769911504
WROL2019_036_ICR-2_p08,0.885323893027291,349,351,11,340,0.968660968660969
WROL2019_036_ICR-3_p08,0.92385614169528,402,406,14,392,0.96551724137931
WROL2019_037_ICR-1_p08,0.726620307871543,152,152,5,147,0.967105263157895
WROL2019_037_ICR-2_p08,0.929423362032012,295,296,10,286,0.966216216216216
WROL2019_037_ICR-3_p08,0.768239793333578,173,173,5,168,0.971098265895954
WROL2019_041_ICR-1_p1,0.743451060607787,142,145,28,117,0.806896551724138
WROL2019_041_ICR-2_p1,0.737179961477565,106,106,12,94,0.886792452830189
WROL2019_041_ICR-3_p1,0.93886622306772,40,40,26,14,0.35
WROL2019_042_ICR-1_p08,0.338248114517398,6,6,3,3,0.5
WROL2019_042_ICR-2_p1,0.711610280836189,80,82,11,71,0.865853658536585
WROL2019_042_ICR-3_p1,0.811683178240791,172,176,24,152,0.863636363636364
WROL2019_043_ICR-1_p1,0.938999408655406,481,486,14,472,0.97119341563786
WROL2019_043_ICR-2_p1,0.889291987163999,92,92,7,85,0.923913043478261
WROL2019_043_ICR-3_p1,0.762767176627681,165,167,14,153,0.916167664670659
WROL2019_044_ICR-1_p08,0.864972513161198,246,248,11,237,0.955645161290323
WROL2019_044_ICR-2_p08,0.753661809625524,83,83,9,74,0.891566265060241
WROL2019_044_ICR-3_p08,0.986186313907383,23,23,16,7,0.304347826086957
WROL2019_045_ICR-1_p08,0.905113712752107,249,250,9,241,0.964
WROL2019_045_ICR-2_p08,0.838432109422048,263,264,6,258,0.977272727272727
WROL2019_045_ICR-3_p1,0.795848649313103,233,233,10,223,0.957081545064378
WROL2019_046_ICR-1_p1,0.564822695504733,60,60,6,54,0.9
WROL2019_046_ICR-2_p08,0.755708565618579,141,142,10,132,0.929577464788732
WROL2019_046_ICR-3_p1,0.594456431480446,75,75,15,60,0.8
WROL2019_047_ICR-1_p08,0.822980496669962,93,94,4,90,0.957446808510638
WROL2019_047_ICR-2_p1,0.715523717068261,101,102,27,75,0.735294117647059
WROL2019_047_ICR-3_p1,0.654394116473838,79,81,14,67,0.827160493827161
WROL2019_048_ICR-1_p08,0.845585047811193,227,230,10,220,0.956521739130435
WROL2019_048_ICR-2_p08,0.8791248863792,261,263,12,251,0.954372623574145
WROL2019_048_ICR-3_p1,0.897398683907026,314,321,22,299,0.931464174454829
WROL2019_049_ICR-1_p08,0.938266875292289,545,549,51,498,0.907103825136612
WROL2019_049_ICR-2_p08,0.943166159471293,538,542,33,509,0.939114391143911
WROL2019_049_ICR-3_p08,0.940628130526959,525,531,42,489,0.92090395480226
WROL2019_050_ICR-1_p1,0.879740590071839,252,256,23,233,0.91015625
WROL2019_050_ICR-2_p08,0.9524344700616,370,374,11,363,0.970588235294118
WROL2019_050_ICR-3_p08,0.736985976428164,142,143,6,137,0.958041958041958
WROL2019_051_ICR-1_p08,0.933930836346655,538,547,28,519,0.948811700182815
WROL2019_051_ICR-2_p08,0.951086537786167,567,578,42,536,0.927335640138408
WROL2019_051_ICR-3_p08,0.749329775996581,219,220,7,213,0.968181818181818
WROL2019_052_ICR-1_p08,0.947484043676807,563,574,33,541,0.942508710801394
WROL2019_052_ICR-2_p08,0.961204640607324,524,531,23,508,0.95668549905838
WROL2019_052_ICR-3_p08,0.920185473706424,459,466,25,441,0.946351931330472
WROL2019_053_ICR-1_p08,0.932510421299499,414,424,29,395,0.931603773584906
WROL2019_053_ICR-2_p08,0.939487503574029,473,486,34,452,0.930041152263374
WROL2019_053_ICR-3_p08,0.918203951679505,394,405,37,368,0.908641975308642
WROL2019_054_ICR-1_p08,0.934352432381865,474,484,38,446,0.921487603305785
WROL2019_054_ICR-2_p08,0.906150629639723,411,420,32,388,0.923809523809524
WROL2019_054_ICR-3_p08,0.933695633617355,529,545,46,499,0.915596330275229
WROL2019_055_ICR-1_p08,0.92542668446632,445,457,43,414,0.905908096280088
WROL2019_055_ICR-2_p08,0.96066893298788,469,479,28,451,0.941544885177453
WROL2019_055_ICR-3_p08,0.911821826135439,378,386,17,369,0.955958549222798
WROL2019_056_ICR-1_p08,0.894120353494246,315,323,23,300,0.928792569659443
WROL2019_056_ICR-2_p08,0.892441638989621,295,302,23,279,0.923841059602649
WROL2019_056_ICR-3_p1,0.841008753868604,240,244,29,215,0.881147540983607
WROL2019_057_ICR-1_p08,0.89532683989458,392,397,20,377,0.949622166246851
WROL2019_057_ICR-2_p08,0.94877992070183,527,543,31,512,0.942909760589319
WROL2019_057_ICR-3_p08,0.947148503088652,520,533,23,510,0.956848030018762
WROL2019_058_ICR-1_p08,0.898548117351262,431,436,15,421,0.965596330275229
WROL2019_058_ICR-2_p08,0.94808717437091,513,528,28,500,0.946969696969697
WROL2019_058_ICR-3_p08,0.922414743893288,423,432,22,410,0.949074074074074
WROL2019_059_ICR-1_p08,0.90222432200356,379,388,35,353,0.90979381443299
WROL2019_059_ICR-2_p08,0.800690164915999,211,213,11,202,0.948356807511737
WROL2019_060_ICR-1_p08,0.937719067516404,421,426,16,410,0.962441314553991
WROL2019_060_ICR-2_p08,0.930247296587757,495,510,33,477,0.935294117647059
WROL2019_060_ICR-3_p08,0.967641426872505,596,610,46,564,0.924590163934426
WROL2019_061_ICR-1_p08,0.761693579627228,258,261,11,250,0.957854406130268
WROL2019_061_ICR-2_p08,0.933143713335346,473,486,33,453,0.932098765432099
WROL2019_061_ICR-3_p08,0.908878960329367,387,394,26,368,0.934010152284264
WROL2019_062_ICR-1_p08,0.827576774250767,186,187,9,178,0.951871657754011
WROL2019_062_ICR-2_p08,0.873913431414375,312,315,22,293,0.93015873015873
WROL2019_062_ICR-3_p08,0.919075704919117,406,411,18,393,0.956204379562044
WROL2019_063_ICR-1_p08,0.94240915750563,584,588,21,567,0.964285714285714
WROL2019_063_ICR-2_p08,0.949783215992611,613,623,41,582,0.934189406099519
WROL2019_063_ICR-3_p08,0.913075061834503,412,412,7,405,0.983009708737864
WROL2019_064_ICR-1_p08,0.942196120531483,648,652,83,569,0.872699386503067
WROL2019_064_ICR-2_p08,0.946493061075418,683,692,55,637,0.920520231213873
WROL2019_064_ICR-3_p1,0.839347363254243,281,285,18,267,0.936842105263158
WROL2019_065_ICR-1_p08,0.952752168442445,608,616,28,588,0.954545454545455
WROL2019_065_ICR-2_p08,0.945890505535297,590,602,52,550,0.913621262458472
WROL2019_065_ICR-3_p08,0.948827879920174,654,661,26,635,0.960665658093797
WROL2019_066_ICR-1_p08,0.937694484947946,493,501,20,481,0.960079840319361
WROL2019_066_ICR-2_p08,0.951869686698119,596,606,31,575,0.948844884488449
WROL2019_066_ICR-3_p08,0.944817385151167,540,552,35,517,0.936594202898551
WROL2019_067_ICR-1_p08,0.921907255157269,483,489,20,469,0.959100204498977
WROL2019_067_ICR-2_p08,0.944189353594793,616,625,43,582,0.9312
WROL2019_067_ICR-3_p08,0.874750459064971,243,246,10,236,0.959349593495935
WROL2019_068_ICR-1_p08,0.92379803525668,526,530,21,509,0.960377358490566
WROL2019_068_ICR-2_p08,0.956370746551406,663,669,52,617,0.922272047832586
WROL2019_068_ICR-3_p08,0.955257112029712,671,677,48,629,0.929098966026588
WROL2019_069_ICR-1_p08,0.948940981468677,653,662,61,601,0.90785498489426
WROL2019_069_ICR-2_p08,0.955120742846597,485,490,12,478,0.975510204081633
WROL2019_069_ICR-3_p08,0.958011611668369,713,728,38,690,0.947802197802198
WROL2019_070_ICR-1_p08,0.950315052594513,642,652,51,601,0.921779141104294
WROL2019_070_ICR-2_p08,0.954659693613321,422,432,22,410,0.949074074074074
WROL2019_070_ICR-3_p08,0.944300168337504,621,630,28,602,0.955555555555556
WROL2019_071_ICR-1_p08,0.949172075089005,629,636,38,598,0.940251572327044
WROL2019_071_ICR-2_p08,0.958830314934205,631,644,35,609,0.945652173913043
WROL2019_071_ICR-3_p08,0.959343904463573,670,682,46,636,0.932551319648094
WROL2019_072_ICR-1_p08,0.950722967897131,526,538,47,491,0.912639405204461
WROL2019_072_ICR-2_p08,0.947539757633966,613,622,48,574,0.922829581993569
WROL2019_072_ICR-3_p08,0.938195001563983,539,550,23,527,0.958181818181818
WROL2019_073_ICR-1_p08,0.960953069896636,575,591,38,553,0.935702199661591
WROL2019_073_ICR-2_p08,0.928037329952721,426,434,17,417,0.960829493087558
WROL2019_073_ICR-3_p08,0.966110643766446,576,591,29,562,0.95093062605753
WROL2019_074_ICR-1_p08,0.823618184906264,204,205,14,191,0.931707317073171
WROL2019_074_ICR-2_p1,0.852623755007293,278,289,27,262,0.906574394463668
WROL2019_074_ICR-3_p1,0.777898542703027,187,188,11,177,0.941489361702128
WROL2019_075_ICR-1_p08,0.824453170617162,203,205,26,179,0.873170731707317
WROL2019_075_ICR-2_p1,0.638854041898745,75,78,12,66,0.846153846153846
WROL2019_075_ICR-3_p08,0.914390921495266,312,319,24,295,0.924764890282132
WROL2019_076_ICR-1_p08,0.933916237320342,471,476,28,448,0.941176470588235
WROL2019_076_ICR-2_p1,0.62113427043536,151,152,12,140,0.921052631578947
WROL2019_076_ICR-3_p08,0.709566526094632,159,161,11,150,0.93167701863354
WROL2019_077_ICR-1_p08,0.732429083281964,154,154,5,149,0.967532467532468
WROL2019_077_ICR-2_p08,0.871542661243144,314,321,15,306,0.953271028037383
WROL2019_077_ICR-3_p08,0.832777739324584,211,213,11,202,0.948356807511737
WROL2019_078_ICR-2_p08,0.93548761229225,582,590,28,562,0.952542372881356
WROL2019_078_ICR-3_p08,0.968421601159141,658,679,73,606,0.892488954344624
WROL2019_079_ICR-1_p08,0.962227197080725,501,512,25,487,0.951171875
WROL2019_079_ICR-2_p08,0.938683671433949,541,550,17,533,0.969090909090909
WROL2019_079_ICR-3_p08,0.966798094894562,596,613,34,579,0.944535073409462
WROL2019_080_ICR-1_p08,0.85481206898113,298,298,5,293,0.983221476510067
WROL2019_080_ICR-2_p08,0.924056920638768,463,472,23,449,0.951271186440678
WROL2019_080_ICR-3_p08,0.894524542566019,324,329,13,316,0.96048632218845
WROL2019_081_ICR-1_p08,0.891712638223248,278,279,13,266,0.953405017921147
WROL2019_081_ICR-2_p08,0.945572395815763,437,439,18,421,0.958997722095672
WROL2019_081_ICR-3_p08,0.928764835982281,409,416,19,397,0.954326923076923
WROL2019_082_ICR-1_p08,0.918964459953927,473,478,24,454,0.949790794979079
WROL2019_082_ICR-2_p08,0.944674538338251,599,602,70,532,0.883720930232558
WROL2019_082_ICR-3_p08,0.938806246279009,595,599,42,557,0.929883138564274
WROL2019_083_ICR-1_p08,0.957798271434665,527,529,17,512,0.967863894139887
WROL2019_083_ICR-2_p08,0.94401142763063,571,579,24,555,0.958549222797927
WROL2019_083_ICR-3_p08,0.929036514997036,401,407,16,391,0.960687960687961
WROL2019_084_ICR-1_p08,0.947906087093308,607,622,29,593,0.953376205787781
WROL2019_084_ICR-2_p08,0.959935717569704,415,419,15,404,0.964200477326969
WROL2019_084_ICR-3_p08,0.906976737128287,349,351,8,343,0.977207977207977
WROL2019_085_ICR-1_p08,0.863436634647145,325,330,14,316,0.957575757575758
WROL2019_085_ICR-2_p08,0.92083588125475,439,446,17,429,0.961883408071749
WROL2019_085_ICR-3_p08,0.903738122519357,358,358,5,353,0.986033519553073
WROL2019_086_ICR-1_p08,0.884394923229656,351,354,9,345,0.974576271186441
WROL2019_086_ICR-2_p08,0.963106544024349,575,589,42,547,0.928692699490662
WROL2019_086_ICR-3_p08,0.941329274038569,585,591,46,545,0.922165820642978
WROL2019_097_ICR-1_p08,0.963275825293266,580,601,44,557,0.926788685524126
WROL2019_097_ICR-2_p08,0.944624066754293,577,586,26,560,0.955631399317406
WROL2019_097_ICR-3_p08,0.947544983523127,560,565,22,543,0.961061946902655
WROL2019_098_ICR-1_p08,0.931620012268924,458,460,17,443,0.96304347826087
WROL2019_098_ICR-2_p08,0.919959095101713,473,476,11,465,0.976890756302521
WROL2019_098_ICR-3_p08,0.956320894133257,580,584,31,553,0.946917808219178
WROL2019_099_ICR-1_p08,0.925316391801075,484,487,24,463,0.950718685831622
WROL2019_099_ICR-2_p08,0.929820016141828,457,461,16,445,0.96529284164859
WROL2019_099_ICR-3_p08,0.899584492395587,428,433,18,415,0.958429561200924
WROL2019_100_ICR-1_p08,0.943243203481117,596,605,31,574,0.948760330578512
WROL2019_100_ICR-2_p08,0.950752768944451,595,607,40,567,0.934102141680395
WROL2019_100_ICR-3_p08,0.939881072747382,517,520,19,501,0.963461538461538
WROL2019_101_ICR-1_p08,0.93316481225873,440,444,8,436,0.981981981981982
WROL2019_101_ICR-2_p08,0.950597345649729,577,591,37,554,0.937394247038917
WROL2019_101_ICR-3_p08,0.941512414915824,532,540,22,518,0.959259259259259
WROL2019_102_ICR-1_p08,0.963651569509943,542,549,23,526,0.958105646630237
WROL2019_102_ICR-2_p08,0.941262711801178,637,641,62,579,0.903276131045242
WROL2019_102_ICR-3_p08,0.940910857080676,608,614,33,581,0.946254071661238
WROL2019_103_ICR-1_p08,0.842018997777364,298,301,20,281,0.933554817275748
WROL2019_103_ICR-2_p08,0.911084349638818,461,465,16,449,0.965591397849462
WROL2019_103_ICR-3_p08,0.948726636313557,641,648,43,605,0.933641975308642
WROL2019_104_ICR-1_p08,0.934374358117721,514,520,31,489,0.940384615384615
WROL2019_104_ICR-2_p08,0.947102355596388,566,579,24,555,0.958549222797927
WROL2019_104_ICR-3_p08,0.920593383251563,389,390,9,381,0.976923076923077
WROL2019_105_ICR-1_p08,0.939120592225424,483,493,30,463,0.939148073022312
WROL2019_105_ICR-2_p08,0.957649122989052,588,596,25,571,0.958053691275168
WROL2019_105_ICR-3_p1,0.864985166627474,325,327,10,317,0.969418960244648
WROL2019_106_ICR-1_p08,0.932886325955755,503,510,36,474,0.929411764705882
WROL2019_106_ICR-2_p08,0.897568595437587,334,336,13,323,0.961309523809524
WROL2019_106_ICR-3_p08,0.916161227985311,431,436,22,414,0.94954128440367
WROL2019_107_ICR-1_p08,0.921671016421264,409,410,8,402,0.980487804878049
WROL2019_107_ICR-2_p08,0.907646871904905,355,358,18,340,0.949720670391061
WROL2019_107_ICR-3_p08,0.919313510221037,352,355,19,336,0.946478873239437
WROL2019_108_ICR-1_p08,0.940188511645572,537,541,16,525,0.970425138632163
WROL2019_108_ICR-2_p1,0.861250576532746,258,260,25,235,0.903846153846154
WROL2019_108_ICR-3_p08,0.922937496275961,550,557,22,535,0.960502692998205
WROL2019_109_ICR-1_p08,0.885645987138623,401,403,14,389,0.965260545905707
WROL2019_109_ICR-2_p08,0.898689677157745,370,374,21,353,0.943850267379679
WROL2019_109_ICR-3_p08,0.95731475424462,539,547,25,522,0.954296160877514
WROL2019_110_ICR-1_p08,0.837508897244487,251,251,9,242,0.964143426294821
WROL2019_110_ICR-2_p08,0.905450131752313,368,371,19,352,0.948787061994609
WROL2019_110_ICR-3_p08,0.674866497765962,157,157,4,153,0.974522292993631
WROL2019_111_ICR-1_p1,0.910011492277088,414,429,41,388,0.904428904428904
WROL2019_111_ICR-2_p08,0.86456607925063,280,283,27,256,0.904593639575972
WROL2019_111_ICR-3_p08,0.954432282314009,423,428,19,409,0.955607476635514
WROL2019_112_ICR-1_p08,0.946572117489435,537,546,33,513,0.93956043956044
WROL2019_112_ICR-2_p08,0.939494082588872,592,605,37,568,0.938842975206612
WROL2019_112_ICR-3_p08,0.927011090607812,511,513,16,497,0.968810916179337
WROL2019_113_ICR-1_p08,0.964230179285835,442,446,18,428,0.959641255605381
WROL2019_113_ICR-2_p08,0.905192320790811,408,413,17,396,0.958837772397094
WROL2019_113_ICR-3_p08,0.919622782614129,405,409,17,392,0.958435207823961
WROL2019_114_ICR-1_p08,0.942283480828891,556,568,34,534,0.940140845070423
WROL2019_114_ICR-2_p08,0.923653561062136,468,472,14,458,0.970338983050847
WROL2019_114_ICR-3_p08,0.909497225932145,409,411,16,395,0.961070559610706
WROL2019_115_ICR-1_p08,0.913948995283806,404,408,19,389,0.95343137254902
WROL2019_115_ICR-2_p08,0.863169622516822,295,298,12,286,0.959731543624161
WROL2019_115_ICR-3_p08,0.853545328143021,271,274,10,264,0.963503649635037
WROL2019_116_ICR-1_p1,0.756651049170519,195,197,10,187,0.949238578680203
WROL2019_116_ICR-2_p08,0.890222276513896,371,374,16,358,0.957219251336898
WROL2019_116_ICR-3_p08,0.92811852711326,485,503,40,463,0.920477137176938
WROL2019_117_ICR-1_p08,0.927664350149985,219,220,18,202,0.918181818181818
WROL2019_117_ICR-2_p1,0.878182652494724,17,17,2,15,0.882352941176471
WROL2019_117_ICR-3_p1,0.887818298048049,279,289,51,238,0.823529411764706
WROL2019_118_ICR-1_p1,0.751781188761944,162,163,16,147,0.901840490797546
WROL2019_118_ICR-2_p08,0.912136912670036,358,361,16,345,0.955678670360111
WROL2019_118_ICR-3_p1,0.747319165854542,163,164,11,153,0.932926829268293
WROL2019_119_ICR-1_p08,0.859294232604818,303,309,15,294,0.951456310679612
WROL2019_119_ICR-2_p08,0.942443254108054,468,477,25,452,0.947589098532495
WROL2019_119_ICR-3_p08,0.943631522360594,319,321,9,312,0.97196261682243
WROL2019_120_ICR-1_p08,0.969553927923688,668,693,57,636,0.917748917748918
WROL2019_120_ICR-2_p08,0.968058431557708,614,626,23,603,0.963258785942492
WROL2019_120_ICR-3_p08,0.955801250914928,609,615,27,588,0.95609756097561
WROL2019_121_ICR-1_p08,0.890515887134953,330,332,19,313,0.942771084337349
WROL2019_121_ICR-2_p08,0.941583601567082,434,437,18,419,0.958810068649886
WROL2019_121_ICR-3_p08,0.917821379909291,403,405,10,395,0.975308641975309
WROL2019_122_ICR-1_p08,0.905173509951549,402,405,23,382,0.94320987654321
WROL2019_122_ICR-2_p08,0.873244314872268,354,354,11,343,0.968926553672316
WROL2019_122_ICR-3_p08,0.957811451797216,422,430,20,410,0.953488372093023
WROL2019_123_ICR-1_p08,0.940644082879607,366,370,13,357,0.964864864864865
WROL2019_123_ICR-2_p1,0.939756136387286,583,593,53,540,0.9106239460371
WROL2019_123_ICR-3_p08,0.861687648998003,268,270,12,258,0.955555555555556
WROL2019_124_ICR-1_p08,0.943677118080951,543,552,22,530,0.960144927536232
WROL2019_124_ICR-2_p08,0.934269778921905,509,517,23,494,0.955512572533849
WROL2019_124_ICR-3_p08,0.95044667578923,542,549,22,527,0.959927140255009
WROL2019_125_ICR-1_p08,0.947693291255044,642,645,29,616,0.955038759689922
WROL2019_125_ICR-2_p08,0.964825623026428,649,665,52,613,0.921804511278196
WROL2019_125_ICR-3_p08,0.929981755239204,447,449,12,437,0.973273942093541
WROL2019_126_ICR-1_p08,0.951491095141076,623,629,33,596,0.947535771065183
WROL2019_126_ICR-2_p08,0.942170328664596,561,562,12,550,0.97864768683274
WROL2019_126_ICR-3_p08,0.973065642342593,646,669,47,622,0.929745889387145
WROL2019_128_ICR-2_p08,0.933577728449826,564,568,22,546,0.961267605633803
WROL2019_128_ICR-3_p08,0.939440259662477,501,503,13,490,0.974155069582505
WROL2019_130_ICR-1_p08,0.948642230780475,579,584,26,558,0.955479452054795
WROL2019_130_ICR-2_p08,0.937370634170188,547,552,27,525,0.951086956521739
WROL2019_130_ICR-3_p08,0.941981786334527,562,569,35,534,0.938488576449912
WROL2019_134_ICR-1_p08,0.93381142105849,493,500,18,482,0.964
WROL2019_134_ICR-2_p08,0.928885232753091,534,539,23,516,0.957328385899815
WROL2019_134_ICR-3_p08,0.937587226947073,493,496,23,473,0.953629032258065
WROL2019_135_ICR-1_p08,0.939104424996111,516,522,24,498,0.954022988505747
WROL2019_135_ICR-2_p08,0.950173519706676,565,571,31,540,0.945709281961471
WROL2019_135_ICR-3_p08,0.936347857762656,461,465,19,446,0.959139784946237
WROL2019_136_ICR-1_p08,0.921369144357701,456,473,57,416,0.879492600422833
WROL2019_136_ICR-2_p08,0.740702038387043,184,184,6,178,0.967391304347826
WROL2019_136_ICR-3_p08,0.883960105496007,313,314,8,306,0.974522292993631
WROL2019_137_ICR-1_p08,0.954565539585338,617,624,20,604,0.967948717948718
WROL2019_137_ICR-2_p08,0.891207400883615,358,360,20,340,0.944444444444444
WROL2019_137_ICR-3_p08,0.969008556406187,529,529,15,514,0.97164461247637
WROL2019_138_ICR-1_p08,0.969710478194324,579,585,18,567,0.969230769230769
WROL2019_138_ICR-2_p08,0.902736675014406,410,411,9,402,0.978102189781022
WROL2019_138_ICR-3_p08,0.929093427923621,519,525,19,506,0.963809523809524
WROL2019_139_ICR-1_p1,0.818452608559867,215,216,8,208,0.962962962962963
WROL2019_139_ICR-2_p08,0.744735795500888,212,213,16,197,0.924882629107981
WROL2019_139_ICR-3_p08,0.892387363381105,336,340,12,328,0.964705882352941
WROL2019_140_ICR-1_p08,0.84600845173993,249,251,14,237,0.944223107569721
WROL2019_140_ICR-2_p1,0.834025616361665,244,250,18,232,0.928
WROL2019_140_ICR-3_p1,0.823089720870056,227,234,11,223,0.952991452991453
WROL2019_145_ICR-1_p08,0.96779724104875,568,591,38,553,0.935702199661591
WROL2019_145_ICR-2_p08,0.866961530029767,357,360,9,351,0.975
WROL2019_145_ICR-3_p1,0.788790823039123,247,248,13,235,0.94758064516129
WROL2019_146_ICR-1_p08,0.924878709095607,476,481,29,452,0.93970893970894
WROL2019_146_ICR-2_p1,0.841615205158519,296,299,16,283,0.946488294314381
WROL2019_146_ICR-3_p08,0.91471619401749,416,417,17,400,0.959232613908873
WROL2019_147_ICR-1_p08,0.922706043734198,390,394,22,372,0.944162436548223
WROL2019_147_ICR-2_p08,0.94456778041444,497,503,19,484,0.962226640159046
WROL2019_147_ICR-3_p08,0.8421522537173,245,248,14,234,0.943548387096774
WROL2019_148_ICR-1_p08,0.949273572564102,628,632,59,573,0.906645569620253
WROL2019_148_ICR-2_p08,0.94733422963472,607,610,52,558,0.914754098360656
WROL2019_148_ICR-3_p08,0.963203251781826,555,561,32,529,0.942959001782531
WROL2019_149_ICR-1_p08,0.964788263780427,529,544,30,514,0.944852941176471
WROL2019_149_ICR-2_p08,0.923530403447147,460,469,21,448,0.955223880597015
WROL2019_149_ICR-3_p08,0.909734115151732,433,443,17,426,0.961625282167043
WROL2019_150_ICR-1_p08,0.782076705659492,246,247,8,239,0.967611336032389
WROL2019_150_ICR-2_p08,0.935557150495888,499,502,17,485,0.966135458167331
WROL2019_150_ICR-3_p08,0.737859476002543,185,185,9,176,0.951351351351351
WROL2019_151_ICR-1_p08,0.922791377383674,359,362,8,354,0.977900552486188
WROL2019_151_ICR-2_p08,0.824129913867386,206,207,6,201,0.971014492753623
WROL2019_151_ICR-3_p08,0.878463667405814,287,289,11,278,0.961937716262976
WROL2019_152_ICR-1_p08,0.938171363277366,420,422,15,407,0.964454976303318
WROL2019_152_ICR-2_p08,0.911098659528141,382,386,14,372,0.963730569948187
WROL2019_152_ICR-3_p08,0.728960116544249,163,166,27,139,0.837349397590361
WROL2019_153_ICR-1_p08,0.93610325059309,506,513,20,493,0.961013645224172
WROL2019_153_ICR-2_p08,0.936546931494761,442,444,14,430,0.968468468468468
WROL2019_153_ICR-3_p08,0.93255205812515,561,569,21,548,0.963093145869947
WROL2019_154_ICR-1_p08,0.926251418823961,418,426,15,411,0.964788732394366
WROL2019_154_ICR-2_p08,0.783127103804071,189,191,7,184,0.963350785340314
WROL2019_154_ICR-3_p08,0.906288954288247,385,390,17,373,0.956410256410256
WROL2019_155_ICR-1_p08,0.93553824631916,559,566,23,543,0.959363957597173
WROL2019_155_ICR-2_p08,0.947939333400373,655,665,58,607,0.912781954887218
WROL2019_155_ICR-3_p08,0.942240699306362,528,535,27,508,0.949532710280374
WROL2019_162_ICR-1_p08,0.562420408397916,509,512,228,284,0.5546875
WROL2019_162_ICR-2_p08,0.951991452077893,660,671,60,611,0.910581222056632
WROL2019_162_ICR-3_p08,0.930193679209696,488,492,15,477,0.969512195121951
WROL2019_164_ICR-1_p08,0.763768823796742,151,153,22,131,0.856209150326797
WROL2019_164_ICR-2_p08,0.876965800601418,280,282,16,266,0.943262411347518
WROL2019_164_ICR-3_p08,0.855669964394585,261,263,15,248,0.942965779467681
WROL2019_165_ICR-1_p08,0.908946749567042,388,393,16,377,0.959287531806616
WROL2019_165_ICR-2_p08,0.935506007176055,461,468,21,447,0.955128205128205
WROL2019_165_ICR-3_p08,0.93638054433539,553,561,29,532,0.948306595365419
WROL2019_166_ICR-1_p08,0.936988482954806,526,530,14,516,0.973584905660377
WROL2019_166_ICR-2_p08,0.954783737060761,638,649,45,604,0.930662557781202
WROL2019_166_ICR-3_p08,0.938969863924275,459,461,12,449,0.973969631236443
WROL2019_167_ICR-1_p08,0.934483125805609,538,545,19,526,0.965137614678899
WROL2019_167_ICR-2_p08,0.917114244803239,509,513,120,393,0.766081871345029
WROL2019_167_ICR-3_p08,0.935008685034412,465,469,12,457,0.974413646055437
WROL2019_168_ICR-1_p08,0.901422275754093,340,343,11,332,0.967930029154519
WROL2019_168_ICR-2_p08,0.917343066988298,457,461,16,445,0.96529284164859
WROL2019_168_ICR-3_p08,0.96380027559423,622,637,64,573,0.899529042386185
WROL2019_169_ICR-1_p08,0.895869861595272,392,393,13,380,0.966921119592875
WROL2019_169_ICR-2_p08,0.813909386847043,249,250,7,243,0.972
WROL2019_169_ICR-3_p08,0.890606019459332,353,355,9,346,0.974647887323944
WROL2019_170_ICR-1_p08,0.951873016287744,676,680,58,622,0.914705882352941
WROL2019_170_ICR-2_p08,0.948261552945867,640,650,45,605,0.930769230769231
WROL2019_170_ICR-3_p08,0.932431242518456,581,585,18,567,0.969230769230769
WROL2019_171_ICR-1_p08,0.936660538760065,567,571,18,553,0.968476357267951
WROL2019_171_ICR-2_p08,0.933240308368899,566,573,23,550,0.959860383944154
WROL2019_171_ICR-3_p08,0.948572775879383,529,532,20,512,0.962406015037594
WROL2019_172_ICR-1_p08,0.923195033985238,477,478,18,460,0.96234309623431
WROL2019_172_ICR-2_p08,0.911721769208659,450,455,22,433,0.951648351648352
WROL2019_172_ICR-3_p08,0.93618984233794,554,559,19,540,0.966010733452594
WROL2019_173_ICR-1_p08,0.936991838954143,466,471,16,455,0.966029723991507
WROL2019_173_ICR-2_p08,0.934980040598114,573,580,48,532,0.917241379310345
WROL2019_173_ICR-3_p08,0.943301832565475,626,639,46,593,0.928012519561815
WROL2019_174_ICR-1_p08,0.945427490602922,573,578,25,553,0.956747404844291
WROL2019_174_ICR-2_p08,0.947348850936667,679,685,43,642,0.937226277372263
WROL2019_174_ICR-3_p08,0.947078725686841,590,592,22,570,0.962837837837838
WROL2019_175_ICR-1_p08,0.150293318359781,565,577,178,399,0.691507798960139
WROL2019_175_ICR-2_p08,0.96477560528282,585,594,27,567,0.954545454545455
WROL2019_175_ICR-3_p08,0.942609699335828,565,567,16,551,0.971781305114638
WROL2019_176_ICR-1_p08,0.92907341083604,507,514,31,483,0.939688715953307
WROL2019_176_ICR-2_p08,0.938008981157218,539,541,24,517,0.955637707948244
WROL2019_176_ICR-3_p08,0.912021045571856,407,411,12,399,0.970802919708029
WROL2019_177_ICR-1_p08,0.957201770854889,591,604,38,566,0.937086092715232
WROL2019_177_ICR-2_p08,0.929618099621044,424,425,7,418,0.983529411764706
WROL2019_177_ICR-3_p08,0.926363445199391,475,479,16,463,0.966597077244259
WROL2019_178_ICR-1_p08,0.947978598655144,679,687,50,637,0.927219796215429
WROL2019_178_ICR-2_p08,0.948770010301312,692,696,41,655,0.941091954022989
WROL2019_178_ICR-3_p08,0.950233282865604,630,637,38,599,0.940345368916798
WROL2019_179_ICR-1_p08,0.947572668191532,634,640,63,577,0.9015625
WROL2019_179_ICR-2_p08,0.945154197596464,509,513,25,488,0.951267056530214
WROL2019_179_ICR-3_p08,0.944943229423049,610,615,74,541,0.879674796747967
WROL2019_180_ICR-1_p08,0.956568210946956,648,658,46,612,0.930091185410334
WROL2019_180_ICR-2_p08,0.958365038158686,643,651,51,600,0.921658986175115
WROL2019_180_ICR-3_p08,0.963913112913746,615,638,50,588,0.921630094043887
WROL2019_181_ICR-1_p08,0.922859952002065,504,507,11,496,0.978303747534517
WROL2019_181_ICR-2_p08,0.944093265170245,580,585,24,561,0.958974358974359
WROL2019_181_ICR-3_p08,0.951367312988502,588,596,22,574,0.963087248322148
WROL2019_182_ICR-1_p08,0.948589865295272,569,574,18,556,0.968641114982578
WROL2019_182_ICR-2_p08,0.964235261258039,610,627,49,578,0.921850079744817
WROL2019_182_ICR-3_p08,0.965170282463821,505,511,20,491,0.960861056751468
WROL2019_183_ICR-1_p08,0.953598053178546,672,676,51,625,0.924556213017751
WROL2019_183_ICR-2_p08,0.930777251835424,547,550,145,405,0.736363636363636
WROL2019_183_ICR-3_p08,0.95015156421971,628,636,31,605,0.95125786163522
WROL2019_184_ICR-1_p08,0.90931905356073,496,498,133,365,0.732931726907631
WROL2019_184_ICR-2_p08,0.95139652644575,627,633,39,594,0.938388625592417
WROL2019_184_ICR-3_p08,0.87010229288352,301,302,11,291,0.963576158940397
WROL2019_185_ICR-1_p08,0.482413927230858,467,471,201,270,0.573248407643312
WROL2019_185_ICR-2_p08,0.934180701394379,487,489,16,473,0.967280163599182
WROL2019_185_ICR-3_p08,0.96197775080987,598,616,92,524,0.850649350649351
WROL2019_186_ICR-1_p08,0.943281984518774,628,634,61,573,0.903785488958991
WROL2019_186_ICR-2_p08,0.956495225478583,673,685,55,630,0.91970802919708
WROL2019_186_ICR-3_p08,0.949109545432336,658,671,51,620,0.923994038748137
WROL2019_188_ICR-1_p08,0.947375925041303,602,609,33,576,0.945812807881773
WROL2019_188_ICR-2_p08,0.935102533910002,515,518,18,500,0.965250965250965
WROL2019_188_ICR-3_p08,0.93361661415868,480,481,14,467,0.970893970893971
WROL2019_189_ICR-1_p08,0.786758157746741,216,216,12,204,0.944444444444444
WROL2019_189_ICR-2_p08,0.918316242887897,418,423,15,408,0.964539007092199
WROL2019_189_ICR-3_p08,0.926992894419047,434,439,20,419,0.954441913439636
WROL2019_190_ICR-1_p08,0.735300320515377,182,182,8,174,0.956043956043956
WROL2019_190_ICR-2_p08,0.872762768970608,335,339,11,328,0.967551622418879
WROL2019_190_ICR-3_p08,0.888968492554192,352,356,12,344,0.966292134831461
WROL2019_192_ICR-1_p08,0.950364335789853,356,360,14,346,0.961111111111111
WROL2019_192_ICR-2_p08,0.928092718334361,395,400,19,381,0.9525
WROL2019_192_ICR-3_p08,0.917832413492091,401,406,17,389,0.958128078817734
WROL2019_193_ICR-2_p08,0.939571476820964,481,487,17,470,0.965092402464066
WROL2019_193_ICR-3_p08,0.950719266857115,626,631,29,602,0.954041204437401
WROL2019_194_ICR-1_p08,0.946920254135458,620,638,49,589,0.923197492163009
WROL2019_194_ICR-2_p08,0.937585045794874,557,564,24,540,0.957446808510638
WROL2019_194_ICR-3_p08,0.968039286716379,584,614,56,558,0.908794788273616
WROL2019_195_ICR-1_p08,0.940824494932057,560,570,27,543,0.952631578947368
WROL2019_195_ICR-2_p08,0.942083780620502,565,567,107,460,0.811287477954145
WROL2019_195_ICR-3_p08,0.941179736454681,623,627,43,584,0.931419457735247
WROL2019_209_ICR-1_p08,0.921752521556893,528,529,135,394,0.744801512287335
WROL2019_209_ICR-2_p08,0.87337558810206,339,341,19,322,0.944281524926686
WROL2019_209_ICR-3_p08,0.942999143582471,599,605,23,582,0.96198347107438
WROL2019_210_ICR-1_p08,0.957207809901896,562,580,125,455,0.78448275862069
WROL2019_210_ICR-2_p08,0.944325190350254,580,592,39,553,0.934121621621622
WROL2019_210_ICR-3_p08,0.900393981141729,374,375,9,366,0.976
WROL2019_211_ICR-1_p08,0.933456520701759,502,508,27,481,0.946850393700787
WROL2019_211_ICR-2_p08,0.891812881624704,330,332,6,326,0.981927710843373
WROL2019_211_ICR-3_p08,0.923911558619194,446,449,18,431,0.959910913140312
WROL2019_212_ICR-1_p08,0.946938375622841,591,601,29,572,0.951747088186356
WROL2019_212_ICR-2_p08,0.958608195528008,598,624,68,556,0.891025641025641
WROL2019_212_ICR-3_p08,0.837974698316459,284,288,22,266,0.923611111111111
WROL2019_213_ICR-1_p08,0.876253057174041,292,294,11,283,0.962585034013605
WROL2019_213_ICR-2_p08,0.955646493421784,389,390,16,374,0.958974358974359
WROL2019_213_ICR-3_p08,0.780582690707189,156,157,14,143,0.910828025477707
WROL2019_215_ICR-1_p08,0.951566369954469,667,682,56,626,0.917888563049853
WROL2019_215_ICR-2_p08,0.92994477481591,571,577,137,440,0.762564991334489
WROL2019_215_ICR-3_p08,0.939236042989178,633,645,44,601,0.931782945736434
WROL2019_216_ICR-1_p08,0.937462135556746,443,446,21,425,0.952914798206278
WROL2019_216_ICR-2_p08,0.923339540067386,432,436,10,426,0.977064220183486
WROL2019_216_ICR-3_p08,0.886097533235433,352,353,17,336,0.951841359773371
WROL2019_1001_ICR-1_p08,0.963742623281917,591,604,44,560,0.927152317880795
WROL2019_1001_ICR-2_p08,0.923292033400869,457,461,22,439,0.952277657266811
WROL2019_1001_ICR-3_p08,0.942616150294918,531,537,24,513,0.955307262569832
WROL2019_1002_ICR-1_p1,0.955243964135558,43,43,17,26,0.604651162790698
WROL2019_1002_ICR-2_p08,0.924909511162873,437,438,17,421,0.961187214611872
WROL2019_1002_ICR-3_p08,0.905728439163799,365,367,13,354,0.964577656675749
WROL2019_1003_ICR-1_p08,0.899640142007519,310,312,10,302,0.967948717948718
WROL2019_1003_ICR-2_p08,0.943149588154635,498,502,25,477,0.950199203187251
WROL2019_1003_ICR-3_p08,0.90389293348835,344,346,12,334,0.965317919075145
WROL2019_1004_ICR-1_p08,0.960551841175671,524,535,95,440,0.822429906542056
WROL2019_1004_ICR-2_p08,0.94193715877387,591,595,70,525,0.882352941176471
WROL2019_1004_ICR-3_p08,0.136586346448592,472,476,200,276,0.579831932773109
RC2_0001_ICR-1_p08,0.927730955909307,663,680,84,596,0.876470588235294
RC2_0001_ICR-2_p08,0.925081376776783,687,716,86,630,0.879888268156425
RC2_0001_ICR-3_p08,0.925071947292809,684,704,73,631,0.896306818181818
RC2_0002_ICR-1_p08,0.938382673020584,696,726,72,654,0.900826446280992
RC2_0002_ICR-2_p08,0.932883660966054,697,725,76,649,0.895172413793103
RC2_0002_ICR-3_p08,0.929411039969385,661,689,95,594,0.862119013062409
RC2_0003_ICR-1_p08,0.935613505620634,673,710,83,627,0.883098591549296
RC2_0003_ICR-2_p08,0.89317925338423,568,573,74,499,0.870855148342059
